Time,lat,long,d,Direction,f,PM1.0,PM2.5,PM10.0,0.3μm,0.5μm,1.0μm,2.5μm,5.0μm,10.0μm,p,1.0,2.5,10.0
2020-12-09T10:56:09.088283,52.5491216667,13.37173, 4homepulse, o,0.0,37,69,75,11027,3340,858,47,5,2,1919,37,32,6
2020-12-09T10:56:10.099793,52.549101666700004,13.371704999999999, 4homepulse, o,0.0,36,69,78,11057,3346,856,53,8,5,1919,36,33,9
2020-12-09T10:56:11.106576,52.5490683333,13.3716833333, 4homepulse, o,0.0,37,69,77,11099,3356,850,57,7,4,1919,37,32,8
2020-12-09T10:56:12.116556,52.5490366667,13.3716583333, 4homepulse, o,0.0,37,69,77,11099,3356,850,57,7,4,1919,37,32,8
2020-12-09T10:56:13.126506,52.5489916667,13.37165, 4homepulse, o,0.0,37,71,79,11308,3388,842,58,7,4,1919,37,34,8
2020-12-09T10:56:14.138311,52.5489566667,13.37163, 4homepulse, o,0.0,37,71,79,11308,3388,842,58,7,4,1919,37,34,8
2020-12-09T10:56:15.148645,52.54894,13.3715916667, 4homepulse, o,0.0,36,70,78,11541,3404,844,56,7,5,1919,36,34,8
2020-12-09T10:56:16.160293,52.548925,13.3715533333, 4homepulse, w,0.0,39,72,85,11870,3605,874,58,12,10,1919,39,33,13
2020-12-09T10:56:17.172951,52.54891,13.3715116667, 4homepulse, w,0.0,39,69,81,11843,3607,842,50,12,10,1919,39,30,12
2020-12-09T10:56:18.185940,52.5488983333,13.3714683333, 4homepulse, w,0.0,39,68,80,12052,3631,854,50,13,10,1919,39,29,12
2020-12-09T10:56:19.198574,52.548885,13.3714216667, 4homepulse, w,0.0,38,71,79,11897,3617,852,56,10,9,1919,38,33,8
2020-12-09T10:56:20.211437,52.5488816667,13.3713616667, 4homepulse, w,0.0,39,72,82,12058,3637,864,60,10,9,1919,39,33,10
2020-12-09T10:56:21.229911,52.54889,13.371285, 4homepulse, w,0.0,39,68,78,12040,3625,834,53,10,9,1919,39,29,10
2020-12-09T10:56:22.245709,52.5489,13.371201666700001, 4homepulse, w,0.0,41,73,83,12121,3656,846,57,10,7,1919,41,32,10
2020-12-09T10:56:23.265567,52.548921666700004,13.371111666700001, 4homepulse, w,0.0,41,72,83,12121,3654,844,57,13,7,1919,41,31,11
2020-12-09T10:56:24.281825,52.54894,13.3710333333, 4homepulse, w,0.0050285174601563,40,72,86,12115,3646,860,65,16,8,1919,40,32,14
2020-12-09T10:56:25.296862,52.54895,13.370963333299999, 4homepulse, w,0.0050285174601563,39,70,83,12034,3632,848,67,15,7,1919,39,31,13
2020-12-09T10:56:26.312397,52.5489616667,13.370895, 4homepulse, w,0.0050285174601563,38,66,75,11571,3433,804,58,10,2,1919,38,28,9
2020-12-09T10:56:27.327771,52.5489633333,13.370835000000001, 4homepulse, w,0.0050285174601563,37,67,76,11586,3431,812,58,10,2,1919,37,30,9
2020-12-09T10:56:28.342889,52.548965,13.370773333299999, 4homepulse, w,0.0050285174601563,39,67,75,11882,3606,796,52,9,2,1919,39,28,8
2020-12-09T10:56:29.359628,52.5489616667,13.370714999999999, 4homepulse, w,0.0050285174601563,39,65,74,12037,3620,798,48,9,2,1919,39,26,9
2020-12-09T10:56:30.375452,52.54896,13.3706533333, 4homepulse, w,0.0050285174601563,39,65,74,12037,3620,798,48,9,2,1919,39,26,9
2020-12-09T10:56:31.391124,52.5489566667,13.370595000000002, 4homepulse, w,0.0050285174601563,39,64,74,11834,3598,796,48,9,2,1919,39,25,10
2020-12-09T10:56:32.407114,52.5489516667,13.370543333299999, 4homepulse, w,0.0047367182490971,39,64,74,11834,3598,796,48,9,2,1919,39,25,10
2020-12-09T10:56:33.423411,52.5489466667,13.370491666700001, 4homepulse, w,0.0047367182490971,38,65,75,11858,3598,788,51,10,2,1919,38,27,10
2020-12-09T10:56:34.440750,52.5489383333,13.370435, 4homepulse, w,0.0047367182490971,38,65,75,11858,3598,788,51,10,2,1919,38,27,10
2020-12-09T10:56:35.457088,52.548935,13.3703783333, 4homepulse, w,0.0047367182490971,38,63,71,11777,3433,772,45,8,1,1919,38,25,8
2020-12-09T10:56:36.481318,52.548935,13.370318333299998, 4homepulse, w,0.0047367182490971,38,63,71,11777,3433,772,45,8,1,1919,38,25,8
2020-12-09T10:56:37.498019,52.5489283333,13.370263333299999, 4homepulse, w,0.0047367182490971,40,66,73,12336,3652,788,41,5,1,1919,40,26,7
2020-12-09T10:56:38.514289,52.548923333299996,13.370204999999999, 4homepulse, w,0.0047367182490971,41,66,70,12614,3693,776,33,3,1,1919,41,25,4
2020-12-09T10:56:39.531328,52.548919999999995,13.3701483333, 4homepulse, w,0.0047367182490971,42,67,70,13089,3876,774,29,3,1,1919,42,25,3
2020-12-09T10:56:40.547765,52.5489133333,13.370095000000001, 4homepulse, w,0.0043732528149146,44,70,76,13436,3947,782,36,8,4,1919,44,26,6
2020-12-09T10:56:41.564124,52.5489083333,13.370045000000001, 4homepulse, w,0.0043732528149146,44,71,79,13854,4118,800,44,9,4,1919,44,27,8
2020-12-09T10:56:42.580858,52.5489033333,13.3699933333, 4homepulse, w,0.0043732528149146,43,67,77,13415,3923,782,44,10,4,1919,43,24,10
2020-12-09T10:56:43.596870,52.5489,13.3699416667, 4homepulse, w,0.0043732528149146,43,68,80,13681,3962,788,48,11,5,1919,43,25,12
2020-12-09T10:56:44.614081,52.548894999999995,13.369888333299999, 4homepulse, w,0.0043732528149146,44,71,83,14132,4133,796,50,12,6,1919,44,27,12
2020-12-09T10:56:45.630427,52.5488916667,13.369835, 4homepulse, w,0.0043732528149146,44,74,86,14180,4152,824,60,11,6,1919,44,30,12
2020-12-09T10:56:46.646336,52.548885,13.369781666700002, 4homepulse, w,0.0043732528149146,45,75,89,14461,4193,846,60,13,7,1919,45,30,14
2020-12-09T10:56:47.662653,52.548876666700004,13.3697283333, 4homepulse, w,0.0043732528149146,47,75,89,14613,4197,854,62,14,7,1919,47,28,14
2020-12-09T10:56:48.686740,52.5488716667,13.3696783333, 4homepulse, w,0.0040788145833242,47,76,90,14461,4191,862,68,13,6,1919,47,29,14
2020-12-09T10:56:49.703942,52.5488683333,13.369625, 4homepulse, w,0.0040788145833242,45,78,96,14613,4195,888,78,18,11,1919,45,33,18
2020-12-09T10:56:50.720477,52.548869999999994,13.369575, 4homepulse, w,0.0040788145833242,45,78,96,14613,4195,888,78,18,11,1919,45,33,18
2020-12-09T10:56:51.736462,52.548875,13.3695283333, 4homepulse, w,0.0040788145833242,45,80,94,14601,4183,1030,80,14,8,1919,45,35,14
2020-12-09T10:56:52.753123,52.548880000000004,13.3694883333, 4homepulse, w,0.0040788145833242,45,80,94,14601,4183,1030,80,14,8,1919,45,35,14
2020-12-09T10:56:53.783928,52.54889,13.369451666700002, 3cobbleGroove2, w,0.0040788145833242,46,81,94,14900,4373,1028,70,14,8,1919,46,35,13
2020-12-09T10:56:54.800455,52.5489033333,13.369420000000002, 3cobbleGroove2, w,0.0040788145833242,46,81,94,14900,4373,1028,70,14,8,1919,46,35,13
2020-12-09T10:56:55.816882,52.5489166667,13.3693966667, 3cobbleGroove2, w,0.0040788145833242,49,82,95,15217,4444,1044,67,13,8,1919,49,33,13
2020-12-09T10:56:56.833981,52.5489333333,13.369376666700001, 3cobbleGroove2, w,0.0030741618432924,47,82,94,14975,4405,1036,67,15,8,1919,47,35,12
2020-12-09T10:56:57.850567,52.5489433333,13.3693566667, 3cobbleGroove2, w,0.0030741618432924,47,81,93,14945,4401,1024,61,14,7,1919,47,34,12
2020-12-09T10:56:58.868282,52.5489566667,13.369333333299998, 3cobbleGroove2, w,0.0030741618432924,48,78,90,14879,4386,870,53,14,7,1919,48,30,12
2020-12-09T10:56:59.885598,52.548966666700004,13.369315, 3cobbleGroove2, w,0.0030741618432924,47,76,88,14619,4215,852,55,14,6,1919,47,29,12
2020-12-09T10:57:00.902876,52.5489783333,13.36929, 3cobbleGroove2, w,0.0030741618432924,44,76,87,14135,4165,842,55,14,6,1919,44,32,11
2020-12-09T10:57:01.920364,52.5489883333,13.369268333299999, 3cobbleGroove2, w,0.0030741618432924,44,76,87,13911,4138,854,53,14,6,1919,44,32,11
2020-12-09T10:57:02.938540,52.5489983333,13.3692466667, 3cobbleGroove2, w,0.0030741618432924,44,74,81,13651,4114,828,49,9,1,1919,44,30,7
2020-12-09T10:57:03.955620,52.54900500000001,13.369228333299999, 3cobbleGroove2, w,0.0030741618432924,44,71,79,13439,3966,820,45,9,1,1919,44,27,8
2020-12-09T10:57:04.973625,52.5490083333,13.3692116667, 3cobbleGroove2, sw,0.0019898087933912,42,71,80,13158,3920,824,55,8,1,1919,42,29,9
2020-12-09T10:57:05.991472,52.549013333299996,13.369193333299998, 3cobbleGroove2, sw,0.0019898087933912,43,72,83,13346,3942,834,64,9,1,1919,43,29,11
2020-12-09T10:57:07.009486,52.5490216667,13.369175, 3cobbleGroove2, sw,0.0019898087933912,46,76,86,13881,4177,848,64,7,1,1919,46,30,10
2020-12-09T10:57:09.027080,52.549080000000004,13.369086666700001, 3cobbleGroove2, sw,0.0019898087933912,48,79,90,14604,4406,880,66,8,1,1919,48,31,11
2020-12-09T10:57:10.044702,52.54911,13.3690633333, 3cobbleGroove2, sw,0.0019898087933912,48,79,90,14604,4406,880,66,8,1,1919,48,31,11
2020-12-09T10:57:11.062653,52.5491416667,13.369041666700001, 3cobbleGroove2, sw,0.0019898087933912,49,80,92,14888,4443,1028,64,9,2,1919,49,31,12
2020-12-09T10:57:12.080922,52.549175,13.3690183333, 3cobbleGroove2, sw,0.0032398582103293,49,81,92,14894,4459,1040,62,7,2,1919,49,32,11
2020-12-09T10:57:13.098836,52.5492066667,13.368993333299999, 3cobbleGroove2, sw,0.0032398582103293,49,82,91,15124,4615,1040,62,6,2,1919,49,33,9
2020-12-09T10:57:14.117252,52.549240000000005,13.3689716667, 3cobbleGroove2, sw,0.0032398582103293,50,83,91,15378,4638,1040,60,6,2,1919,50,33,8
2020-12-09T10:57:15.134857,52.5492716667,13.368953333299999, 3cobbleGroove2, sw,0.0032398582103293,51,84,93,15698,4686,1046,58,7,2,1919,51,33,9
2020-12-09T10:57:16.152896,52.549303333299996,13.3689316667, 3cobbleGroove2, sw,0.0032398582103293,53,86,94,15970,4720,1042,56,6,2,1919,53,33,8
2020-12-09T10:57:17.170499,52.5493366667,13.368908333299999, 3cobbleGroove2, sw,0.0032398582103293,52,84,93,15710,4661,1028,56,9,3,1919,52,32,9
2020-12-09T10:57:18.188376,52.549369999999996,13.368885, 3cobbleGroove2, sw,0.0032398582103293,49,83,91,15450,4613,894,54,9,3,1919,49,34,8
2020-12-09T10:57:19.205847,52.5494033333,13.36886, 3cobbleGroove2, sw,0.0032398582103293,47,81,89,14975,4399,890,52,11,2,1919,47,34,8
2020-12-09T10:57:20.223410,52.549436666700004,13.3688316667, 3cobbleGroove2, sw,0.0045308255475103,44,78,85,14344,4143,868,56,11,2,1919,44,34,7
2020-12-09T10:57:21.241777,52.5494716667,13.368803333299999, 3cobbleGroove2, sw,0.0045308255475103,43,74,82,13845,3938,848,58,11,1,1919,43,31,8
2020-12-09T10:57:22.259544,52.5495066667,13.3687816667, 3cobbleGroove2, sw,0.0045308255475103,43,73,81,13648,3918,836,58,10,1,1919,43,30,8
2020-12-09T10:57:23.278335,52.5495416667,13.368761666700001, 3cobbleGroove2, sw,0.0045308255475103,41,70,80,13313,3845,822,62,11,1,1919,41,29,10
2020-12-09T10:57:24.296170,52.5495783333,13.3687416667, 3cobbleGroove2, sw,0.0045308255475103,41,70,80,13313,3845,822,62,11,1,1919,41,29,10
2020-12-09T10:57:25.315177,52.5496133333,13.3687216667, 3cobbleGroove2, sw,0.0045308255475103,41,68,80,13101,3705,812,64,16,1,1919,41,27,12
2020-12-09T10:57:26.331737,52.5496483333,13.368701666700002, 3cobbleGroove2, sw,0.0045308255475103,41,68,79,13101,3705,812,64,16,1,1919,41,27,11
2020-12-09T10:57:27.349439,52.5496833333,13.36868, 3cobbleGroove2, sw,0.0045308255475103,38,66,78,12623,3646,818,66,16,1,1919,38,28,12
2020-12-09T10:57:28.366298,52.5497166667,13.368656666700002, 3cobbleGroove2, sw,0.0047581821523699,38,66,78,12623,3646,818,66,16,1,1919,38,28,12
2020-12-09T10:57:29.383750,52.549751666700004,13.368635000000001, 3cobbleGroove2, sw,0.0047581821523699,36,64,78,11900,3427,820,72,17,2,1919,36,28,14
2020-12-09T10:57:30.399408,52.5497866667,13.36861, 3cobbleGroove2, sw,0.0047581821523699,36,64,78,11900,3427,820,72,17,2,1919,36,28,14
2020-12-09T10:57:31.415785,52.5498216667,13.368585000000001, 3cobbleGroove2, sw,0.0047581821523699,37,66,77,12306,3604,840,66,14,1,1919,37,29,11
2020-12-09T10:57:32.432174,52.54985500000001,13.36856, 3cobbleGroove2, sw,0.0047581821523699,37,65,77,12312,3604,832,62,14,2,1919,37,28,12
2020-12-09T10:57:33.448361,52.5498883333,13.3685366667, 3cobbleGroove2, sw,0.0047581821523699,37,66,75,12336,3606,816,58,11,2,1919,37,29,9
2020-12-09T10:57:34.465672,52.5499216667,13.3685133333, 3cobbleGroove2, sw,0.0047581821523699,37,66,76,12306,3625,822,54,11,2,1919,37,29,10
2020-12-09T10:57:35.468128,52.549955000000004,13.368488333299998, 3cobbleGroove2, sw,0.0047581821523699,39,68,80,12569,3661,826,60,13,3,1919,39,29,12
2020-12-09T10:57:36.489895,52.549965,13.3684566667, 3cobbleGroove2, sw,0.0043924315395357,41,72,85,13355,3918,852,62,14,4,1919,41,31,13
2020-12-09T10:57:37.507430,52.549980000000005,13.368429999999998, 3cobbleGroove2, sw,0.0043924315395357,41,72,82,13155,3898,848,54,13,4,1919,41,31,10
2020-12-09T10:57:38.523010,52.549996666700004,13.3683983333, 3cobbleGroove2, sw,0.0043924315395357,38,69,78,12572,3668,826,54,11,5,1919,38,31,9
2020-12-09T10:57:39.539716,52.5500133333,13.3683683333, 3cobbleGroove2, sw,0.0043924315395357,36,63,72,11867,3448,790,48,10,5,1919,36,27,9
2020-12-09T10:57:40.554868,52.550035,13.36834, 3cobbleGroove2, sw,0.0043924315395357,36,61,69,11601,3399,774,44,9,4,1919,36,25,8
2020-12-09T10:57:41.571232,52.5500566667,13.368314999999999, 3cobbleGroove2, sw,0.0043924315395357,34,59,67,11108,3340,628,42,10,5,1919,34,25,8
2020-12-09T10:57:42.587141,52.55008,13.36829, 3cobbleGroove2, sw,0.0043924315395357,34,59,65,11030,3199,622,44,9,4,1919,34,25,6
2020-12-09T10:57:43.603885,52.5501016667,13.3682616667, 3cobbleGroove2, sw,0.0043924315395357,32,58,64,10349,3110,626,44,9,4,1919,32,26,6
2020-12-09T10:57:44.619880,52.5501233333,13.368231666700002, 3cobbleGroove2, sw,0.0033240360369489,32,58,64,10349,3110,626,44,9,4,1919,32,26,6
2020-12-09T10:57:45.636244,52.5501466667,13.368203333299999, 3cobbleGroove2, sw,0.0033240360369489,31,55,63,10274,3075,624,46,9,4,1919,31,24,8
2020-12-09T10:57:46.659640,52.5501716667,13.368175, 3cobbleGroove2, sw,0.0033240360369489,33,56,62,10534,3128,630,36,7,4,1919,33,23,6
2020-12-09T10:57:47.676010,52.5501983333,13.368146666700001, 3cobbleGroove2, sw,0.0033240360369489,31,51,58,9993,2897,626,30,6,3,1919,31,20,7
2020-12-09T10:57:48.694510,52.550225,13.3681183333, 3cobbleGroove2, sw,0.0033240360369489,32,54,60,10274,3082,774,29,6,3,1919,32,22,6
2020-12-09T10:57:49.712159,52.5502516667,13.368089999999999, 3cobbleGroove2, sw,0.0033240360369489,34,58,61,10845,3188,796,25,3,2,1919,34,24,3
2020-12-09T10:57:50.726205,52.55028000000001,13.368065, 3cobbleGroove2, sw,0.0033240360369489,36,61,65,11556,3402,826,25,3,2,1919,36,25,4
2020-12-09T10:57:51.743241,52.5503066667,13.368039999999999, 3cobbleGroove2, sw,0.0033240360369489,37,63,68,12088,3619,842,27,3,2,1919,37,26,5
2020-12-09T10:57:52.761145,52.550333333299996,13.3680166667, 3cobbleGroove2, sw,0.0039294311288154,39,65,69,12303,3656,836,31,3,2,1919,39,26,4
2020-12-09T10:57:53.778156,52.5503616667,13.3679983333, 3cobbleGroove2, sw,0.0039294311288154,39,66,70,12363,3663,860,27,3,2,1919,39,27,4
2020-12-09T10:57:54.795981,52.55039,13.3679783333, 3cobbleGroove2, sw,0.0039294311288154,41,70,74,12844,3866,874,35,4,2,1919,41,29,4
2020-12-09T10:57:55.813258,52.5504183333,13.367958333299999, 3cobbleGroove2, sw,0.0039294311288154,42,71,78,13095,3903,864,43,6,2,1919,42,29,7
2020-12-09T10:57:56.830040,52.5504466667,13.367935000000001, 3cobbleGroove2, sw,0.0039294311288154,40,72,77,12829,3858,880,49,5,1,1919,40,32,5
2020-12-09T10:57:57.848080,52.550475,13.367915, 3cobbleGroove2, sw,0.0039294311288154,40,72,80,12877,3873,876,53,8,1,1919,40,32,8
2020-12-09T10:57:58.881886,52.550505,13.3678933333, none, sw,0.0039294311288154,40,72,80,12877,3873,876,53,8,1,1919,40,32,8
2020-12-09T10:57:59.899817,52.5505333333,13.367868333299999, none, sw,0.0039294311288154,41,72,79,12883,3864,862,56,9,1,1919,41,31,7
2020-12-09T10:58:00.917821,52.5505616667,13.36784, none, sw,0.004008446094764,39,70,80,12802,3697,852,58,12,4,1919,39,31,10
2020-12-09T10:58:01.934697,52.5505916667,13.36781, none, sw,0.004008446094764,39,70,83,12599,3687,848,60,15,5,1919,39,31,13
2020-12-09T10:58:02.952471,52.5506233333,13.367779999999998, none, sw,0.004008446094764,39,68,82,12405,3669,834,60,18,5,1919,39,29,14
2020-12-09T10:58:03.970140,52.5506566667,13.3677533333, none, sw,0.004008446094764,39,71,84,12665,3695,858,60,17,4,1919,39,32,13
2020-12-09T10:58:04.986119,52.5506883333,13.367729999999998, none, sw,0.004008446094764,39,71,84,12623,3682,850,64,18,4,1919,39,32,13
2020-12-09T10:58:06.003648,52.55072,13.3677033333, none, sw,0.004008446094764,40,66,80,12605,3675,822,54,17,4,1919,40,26,14
2020-12-09T10:58:08.020959,52.5508166667,13.367635, none, sw,0.004008446094764,41,67,78,12611,3687,820,48,14,4,1919,41,26,11
2020-12-09T10:58:09.037837,52.550846666700004,13.3676133333, none, sw,0.0050288283631425,42,65,78,12629,3696,808,44,15,4,1919,42,23,13
2020-12-09T10:58:10.054708,52.5508783333,13.367588333299999, none, sw,0.0050288283631425,42,65,78,12647,3710,802,46,15,5,1919,42,23,13
2020-12-09T10:58:11.071381,52.5509083333,13.367564999999999, none, sw,0.0050288283631425,43,67,80,13101,3901,810,46,15,5,1919,43,24,13
2020-12-09T10:58:12.088897,52.550940000000004,13.367543333299999, none, sw,0.0050288283631425,44,70,80,13334,3936,812,48,12,2,1919,44,26,10
2020-12-09T10:58:13.105365,52.55096999999999,13.3675183333, none, sw,0.0050288283631425,44,71,79,13397,3952,816,50,9,1,1919,44,27,8
2020-12-09T10:58:14.122397,52.5510016667,13.367498333299999, none, sw,0.0050288283631425,44,71,79,13397,3952,816,50,9,1,1919,44,27,8
2020-12-09T10:58:15.138770,52.5510333333,13.367479999999999, none, sw,0.0050288283631425,44,73,79,13660,4115,852,43,6,1,1919,44,29,6
2020-12-09T10:58:16.156194,52.5510616667,13.3674633333, none, sw,0.0050288283631425,44,73,79,13660,4115,852,43,6,1,1919,44,29,6
2020-12-09T10:58:17.173424,52.5510883333,13.36744, none, sw,0.0041880590747822,44,69,78,13588,4101,838,39,7,1,1919,44,25,9
2020-12-09T10:58:18.197963,52.5511116667,13.3674166667, none, sw,0.0041880590747822,44,69,78,13588,4101,838,39,7,1,1919,44,25,9
2020-12-09T10:58:19.214906,52.5511333333,13.367389999999999, none, sw,0.0041880590747822,44,70,77,13576,4109,834,37,6,1,1919,44,26,7
2020-12-09T10:58:20.231411,52.5511566667,13.3673666667, none, sw,0.0041880590747822,44,70,77,13576,4109,834,37,6,1,1919,44,26,7
2020-12-09T10:58:21.248522,52.5511783333,13.367339999999999, none, sw,0.0041880590747822,44,70,78,13666,4120,844,39,6,1,1919,44,26,8
2020-12-09T10:58:22.266137,52.5511983333,13.367311666700001, none, sw,0.0041880590747822,44,70,78,13666,4120,844,39,6,1,1919,44,26,8
2020-12-09T10:58:23.283214,52.5512166667,13.3672866667, none, sw,0.0041880590747822,44,69,76,13630,4101,834,32,6,1,1919,44,25,7
2020-12-09T10:58:24.301143,52.551235,13.367268333299998, none, sw,0.0041880590747822,44,69,76,13630,4101,834,32,6,1,1919,44,25,7
2020-12-09T10:58:25.318210,52.551251666700004,13.367246666700002, none, sw,0.0031967080855315,45,68,74,13860,4133,828,30,6,2,1919,45,23,6
2020-12-09T10:58:26.334734,52.551269999999995,13.3672283333, none, sw,0.0031967080855315,45,68,74,13860,4133,828,30,6,2,1919,45,23,6
2020-12-09T10:58:27.351229,52.5512883333,13.367213333299999, none, sw,0.0031967080855315,45,68,72,13684,4115,816,26,3,1,1919,45,23,4
2020-12-09T10:58:28.368022,52.551305000000006,13.367195, none, sw,0.0031967080855315,45,68,72,13684,4115,816,26,3,1,1919,45,23,4
2020-12-09T10:58:29.385268,52.5513233333,13.3671783333, none, sw,0.0031967080855315,42,67,70,13316,3918,820,32,2,1,1919,42,25,3
2020-12-09T10:58:30.401866,52.5513416667,13.36716, none, sw,0.0031967080855315,42,67,70,13316,3918,820,32,2,1,1919,42,25,3
2020-12-09T10:58:31.418432,52.551359999999995,13.367145, none, sw,0.0031967080855315,41,68,73,13089,3897,840,34,3,2,1919,41,27,5
2020-12-09T10:58:32.435369,52.5513783333,13.3671266667, none, sw,0.0031967080855315,41,68,73,13089,3897,840,34,3,2,1919,41,27,5
2020-12-09T10:58:33.451538,52.5513966667,13.3671083333, none, sw,0.0026628203604762,41,67,73,12886,3875,842,32,4,2,1919,41,26,6
2020-12-09T10:58:34.468777,52.551415000000006,13.3670916667, none, sw,0.0026628203604762,41,67,73,12886,3875,842,32,4,2,1919,41,26,6
2020-12-09T10:58:35.485069,52.5514316667,13.367075, none, sw,0.0026628203604762,41,67,74,12916,3877,832,35,5,3,1919,41,26,7
2020-12-09T10:58:36.501773,52.5514466667,13.3670566667, none, sw,0.0026628203604762,41,67,74,12916,3877,832,35,5,3,1919,41,26,7
2020-12-09T10:58:37.518351,52.5514616667,13.36704, none, sw,0.0026628203604762,40,66,72,12832,3848,832,33,4,3,1919,40,26,6
2020-12-09T10:58:38.534530,52.551475,13.367023333299999, none, sw,0.0026628203604762,40,66,72,12832,3848,832,33,4,3,1919,40,26,6
2020-12-09T10:58:39.552141,52.551485,13.3670066667, none, sw,0.0026628203604762,42,68,74,13122,3881,840,35,4,3,1919,42,26,6
2020-12-09T10:58:40.568258,52.551494999999996,13.3669966667, none, sw,0.0026628203604762,42,68,74,13322,3913,842,32,4,3,1919,42,26,6
2020-12-09T10:58:41.584709,52.551505000000006,13.3669916667, none, sw,0.0020570755180568,41,71,78,13134,3891,846,41,5,4,1919,41,30,7
2020-12-09T10:58:42.601011,52.5515016667,13.367004999999999, none, sw,0.0020570755180568,40,70,79,12874,3844,840,49,5,3,1919,40,30,9
2020-12-09T10:58:43.617355,52.551496666700004,13.367016666700001, none, sw,0.0020570755180568,39,69,78,12629,3679,832,51,5,3,1919,39,30,9
2020-12-09T10:58:44.634626,52.5514933333,13.367028333299999, none, sw,0.0020570755180568,39,67,76,12853,3693,828,45,5,3,1919,39,28,9
2020-12-09T10:58:45.650298,52.55149,13.3670366667, none, sw,0.0020570755180568,40,67,76,13146,3874,822,41,4,2,1919,40,27,9
2020-12-09T10:58:46.666548,52.55149,13.3670416667, none, sw,0.0020570755180568,43,70,77,13851,3967,824,41,3,2,1919,43,27,7
2020-12-09T10:58:47.683272,52.55149,13.3670433333, none, sw,0.0020570755180568,44,72,77,13923,4121,834,45,2,1,1919,44,28,5
2020-12-09T10:58:48.699460,52.5514933333,13.367045000000001, none, sw,0.0020570755180568,44,74,80,14093,4132,854,55,3,1,1919,44,30,6
2020-12-09T10:58:49.716388,52.551498333299996,13.3670466667, none, e,0.00054180888332852,42,71,78,13588,3927,840,53,4,2,1919,42,29,7
2020-12-09T10:58:50.732592,52.5515016667,13.3670516667, none, e,0.00054180888332852,44,73,80,13648,3945,850,60,4,2,1919,44,29,7
2020-12-09T10:58:51.748849,52.551505000000006,13.367054999999999, none, e,0.00054180888332852,44,73,79,13690,4100,848,56,3,1,1919,44,29,6
2020-12-09T10:58:52.765183,52.5515083333,13.3670566667, none, e,0.00054180888332852,45,76,80,13890,4125,856,60,3,1,1919,45,31,4
2020-12-09T10:58:53.782237,52.5515083333,13.3670533333, none, e,0.00054180888332852,46,76,80,14141,4164,862,56,3,1,1919,46,30,4
2020-12-09T10:58:54.806018,52.5515116667,13.3670483333, none, e,0.00054180888332852,47,78,81,14383,4205,878,54,3,1,1919,47,31,3
2020-12-09T10:58:55.826840,52.55152,13.367045000000001, none, e,0.00054180888332852,47,77,81,14401,4203,858,54,4,2,1919,47,30,4
2020-12-09T10:58:56.847614,52.55153000000001,13.3670366667, none, e,0.00054180888332852,44,74,79,13824,3962,834,56,5,2,1919,44,30,5
2020-12-09T10:58:57.872261,52.551543333299996,13.3670316667, none, s,0.0007294640518495099,42,70,76,13624,3933,810,54,6,2,1919,42,28,6
2020-12-09T10:58:58.890885,52.5515616667,13.367026666700001, none, s,0.0007294640518495099,42,71,75,13648,3943,810,50,5,2,1919,42,29,4
2020-12-09T10:58:59.907185,52.551584999999996,13.367021666700001, none, s,0.0007294640518495099,44,72,76,13911,4115,810,54,4,1,1919,44,28,4
2020-12-09T10:59:00.906620,52.5516116667,13.3670316667, none, s,0.0007294640518495099,43,73,78,13911,4107,810,60,7,1,1919,43,30,5
2020-12-09T10:59:01.932595,52.5516416667,13.3670416667, none, s,0.0007294640518495099,44,76,82,14087,4107,822,56,7,1,1919,44,32,6
2020-12-09T10:59:02.948510,52.5516733333,13.3670483333, none, s,0.0007294640518495099,43,75,82,13887,3964,840,50,9,2,1919,43,32,7
2020-12-09T10:59:03.971341,52.551705000000005,13.36705, none, s,0.0007294640518495099,44,76,83,14099,4118,856,49,9,2,1919,44,32,7
2020-12-09T10:59:04.975375,52.5517383333,13.3670483333, none, s,0.0007294640518495099,43,73,79,13839,3945,846,48,9,2,1919,43,30,6
2020-12-09T10:59:05.997895,52.55177,13.367045000000001, none, s,0.0036028986402746,40,72,78,13421,3890,860,48,8,1,1919,40,32,6
2020-12-09T10:59:07.023880,52.5518033333,13.367045000000001, none, s,0.0036028986402746,40,72,78,13421,3890,860,48,8,1,1919,40,32,6
2020-12-09T10:59:09.041232,52.5519,13.367026666700001, none, s,0.0036028986402746,42,72,79,13594,3924,876,46,8,1,1919,42,30,7
2020-12-09T10:59:10.058626,52.551935,13.367021666700001, none, s,0.0036028986402746,42,72,79,13594,3924,876,46,8,1,1919,42,30,7
2020-12-09T10:59:11.075852,52.551966666700004,13.3670133333, none, s,0.0036028986402746,43,73,79,13636,3951,880,44,8,1,1919,43,30,6
2020-12-09T10:59:12.094708,52.552,13.3670066667, none, s,0.0036028986402746,43,73,79,13636,3951,880,44,8,1,1919,43,30,6
2020-12-09T10:59:13.098009,52.552035,13.367, none, s,0.0042319017109233,44,70,78,13606,3945,840,40,9,2,1919,44,26,8
2020-12-09T10:59:14.119295,52.5520683333,13.3669916667, none, s,0.0042319017109233,44,70,78,13606,3945,840,40,9,2,1919,44,26,8
2020-12-09T10:59:15.136254,52.552101666700004,13.366981666700001, none, s,0.0042319017109233,44,71,79,13678,4102,864,38,9,2,1919,44,27,8
2020-12-09T10:59:16.153074,52.552135,13.3669683333, none, s,0.0042319017109233,43,68,75,13131,3895,858,30,7,3,1919,43,25,7
2020-12-09T10:59:17.169653,52.5521683333,13.3669516667, none, s,0.0042319017109233,43,68,77,13065,3890,860,36,8,4,1919,43,25,9
2020-12-09T10:59:18.188605,52.5522016667,13.36694, none, s,0.0042319017109233,43,68,74,12907,3890,844,32,5,3,1919,43,25,6
2020-12-09T10:59:19.205064,52.552236666700004,13.366929999999998, none, s,0.0042319017109233,42,67,76,12847,3878,842,39,6,3,1919,42,25,9
2020-12-09T10:59:20.210358,52.55226999999999,13.3669166667, none, s,0.0042319017109233,44,68,78,13059,3915,840,42,7,3,1919,44,24,10
2020-12-09T10:59:21.230379,52.552301666700004,13.3669033333, none, s,0.0043376737188688,45,68,79,13101,3938,842,46,8,4,1919,45,23,11
2020-12-09T10:59:22.250883,52.5523333333,13.366888333299999, none, s,0.0043376737188688,45,72,81,13585,4125,858,48,7,4,1919,45,27,9
2020-12-09T10:59:23.267497,52.5523633333,13.366871666700002, none, s,0.0043376737188688,45,75,84,13675,4149,878,54,6,4,1919,45,30,9
2020-12-09T10:59:24.285116,52.552393333299996,13.3668533333, none, s,0.0043376737188688,45,77,86,13645,4143,1040,58,6,4,1919,45,32,9
2020-12-09T10:59:25.301692,52.552425,13.366835, none, s,0.0043376737188688,44,76,85,13603,4135,1030,56,6,4,1919,44,32,9
2020-12-09T10:59:26.319422,52.5524583333,13.3668183333, none, s,0.0043376737188688,45,77,85,13866,4186,1034,54,5,3,1919,45,32,8
2020-12-09T10:59:27.332793,52.5524933333,13.3668016667, none, s,0.0043376737188688,47,76,83,14090,4217,1024,50,4,2,1919,47,29,7
2020-12-09T10:59:28.348291,52.552528333299996,13.366786666700001, none, s,0.0043376737188688,47,76,83,14090,4217,1024,50,4,2,1919,47,29,7
2020-12-09T10:59:29.368626,52.5525616667,13.366776666700002, none, sw,0.0043074833190523,47,76,85,14156,4358,1040,52,5,3,1919,47,29,9
2020-12-09T10:59:30.383355,52.5525983333,13.3667616667, none, sw,0.0043074833190523,47,76,85,14156,4358,1040,52,5,3,1919,47,29,9
2020-12-09T10:59:31.398858,52.5526333333,13.366748333299999, none, sw,0.0043074833190523,47,75,83,14102,4212,1026,46,4,3,1919,47,28,8
2020-12-09T10:59:32.417988,52.5526666667,13.366731666700002, none, sw,0.0043074833190523,47,75,83,14102,4212,1026,46,4,3,1919,47,28,8
2020-12-09T10:59:33.427159,52.5527,13.366715, none, sw,0.0043074833190523,46,74,81,13896,4188,890,43,3,3,1919,46,28,7
2020-12-09T10:59:34.449584,52.5527333333,13.366696666700001, none, sw,0.0043074833190523,46,74,81,13896,4188,890,43,3,3,1919,46,28,7
2020-12-09T10:59:35.465934,52.5527666667,13.3666833333, none, sw,0.0043074833190523,46,73,77,13842,4177,872,36,2,2,1919,46,27,4
2020-12-09T10:59:36.482354,52.5528016667,13.3666716667, none, sw,0.0043074833190523,46,73,77,13842,4177,872,36,2,2,1919,46,27,4
2020-12-09T10:59:37.499759,52.5528383333,13.3666566667, none, sw,0.0045450928356738,45,71,76,13394,4129,860,32,2,2,1919,45,26,5
2020-12-09T10:59:38.515987,52.552875,13.36664, none, sw,0.0045450928356738,45,71,76,13394,4129,860,32,2,2,1919,45,26,5
2020-12-09T10:59:39.533352,52.55291,13.366625, none, sw,0.0045450928356738,45,71,75,13322,4105,852,32,2,2,1919,45,26,4
2020-12-09T10:59:40.550050,52.5529466667,13.366608333299999, none, sw,0.0045450928356738,45,70,74,13382,4109,842,30,2,2,1919,45,25,4
2020-12-09T10:59:41.566250,52.552985,13.366593333299999, none, sw,0.0045450928356738,44,69,73,13316,3950,830,32,2,2,1919,44,25,4
2020-12-09T10:59:42.582640,52.5530216667,13.3665766667, none, sw,0.0045450928356738,43,70,75,13134,3919,824,40,3,3,1919,43,27,5
2020-12-09T10:59:43.599818,52.5530566667,13.36656, none, sw,0.0045450928356738,42,70,75,13062,3891,832,40,3,3,1919,42,28,5
2020-12-09T10:59:44.616493,52.5530916667,13.366545, none, sw,0.0045450928356738,43,73,76,13182,3921,828,48,3,3,1919,43,30,3
2020-12-09T10:59:45.633170,52.5531266667,13.3665266667, none, sw,0.004749147370130999,43,74,78,13334,3931,842,52,4,3,1919,43,31,4
2020-12-09T10:59:46.649815,52.5531616667,13.366511666700001, none, sw,0.004749147370130999,43,77,84,13400,3953,868,63,7,3,1919,43,34,7
2020-12-09T10:59:47.666076,52.5531983333,13.3664933333, none, sw,0.004749147370130999,43,78,85,13630,4110,884,66,7,3,1919,43,35,7
2020-12-09T10:59:48.682446,52.553235,13.3664766667, none, sw,0.004749147370130999,44,80,87,13926,4152,882,72,8,4,1919,44,36,7
2020-12-09T10:59:49.700103,52.5532733333,13.366458333299999, none, sw,0.004749147370130999,46,81,88,13950,4172,890,76,8,4,1919,46,35,7
2020-12-09T10:59:50.716232,52.5533116667,13.3664433333, none, sw,0.004749147370130999,46,80,87,13687,4141,882,74,8,4,1919,46,34,7
2020-12-09T10:59:51.733056,52.55335,13.3664283333, none, sw,0.004749147370130999,46,82,88,13947,4184,890,76,8,4,1919,46,36,6
2020-12-09T10:59:52.749828,52.5533866667,13.366411666700001, none, sw,0.004749147370130999,46,82,88,14353,4365,1030,68,7,3,1919,46,36,6
2020-12-09T10:59:53.767396,52.553423333299996,13.3663983333, none, sw,0.0048728084819421,48,81,87,14401,4375,1024,65,7,3,1919,48,33,6
2020-12-09T10:59:54.788166,52.5534616667,13.3663866667, none, sw,0.0048728084819421,49,82,88,14876,4448,1058,57,6,2,1919,49,33,6
2020-12-09T10:59:55.804469,52.5534983333,13.366371666700001, none, sw,0.0048728084819421,50,86,94,15399,4640,1078,63,6,2,1919,50,36,8
2020-12-09T10:59:56.820338,52.5535366667,13.3663533333, none, sw,0.0048728084819421,51,85,89,15393,4626,1058,55,3,2,1919,51,34,4
2020-12-09T10:59:57.836830,52.553575,13.3663383333, none, sw,0.0048728084819421,50,84,89,15187,4471,1064,53,3,2,1919,50,34,5
2020-12-09T10:59:58.852169,52.5536133333,13.366320000000002, none, sw,0.0048728084819421,49,83,87,14933,4439,1074,49,2,1,1919,49,34,4
2020-12-09T10:59:59.871856,52.553646666700004,13.3662983333, none, sw,0.0048728084819421,49,80,86,15139,4449,1068,39,3,2,1919,49,31,6
2020-12-09T11:00:00.890121,52.5536816667,13.366278333299999, none, sw,0.0048728084819421,51,86,91,15901,4690,1094,45,3,2,1919,51,35,5
2020-12-09T11:00:01.909796,52.5537166667,13.366261666700002, none, sw,0.004842934691626,51,85,91,15677,4660,1090,45,3,2,1919,51,34,6
2020-12-09T11:00:02.928354,52.553755,13.3662416667, none, sw,0.004842934691626,51,84,90,15447,4630,1078,49,3,2,1919,51,33,6
2020-12-09T11:00:03.933657,52.5537916667,13.366226666700001, none, sw,0.004842934691626,51,86,92,15483,4644,1074,56,3,2,1919,51,35,6
2020-12-09T11:00:04.954628,52.553830000000005,13.3662116667, none, sw,0.004842934691626,49,80,87,14906,4413,1026,52,4,3,1919,49,31,7
2020-12-09T11:00:05.978976,52.5538683333,13.3661966667, none, sw,0.004842934691626,49,80,86,14936,4419,878,48,6,4,1919,49,31,6
2020-12-09T11:00:07.002001,52.5539066667,13.366179999999998, none, sw,0.004842934691626,50,82,88,15178,4459,1034,48,6,4,1919,50,32,6
2020-12-09T11:00:08.022148,52.553945,13.3661633333, none, sw,0.004842934691626,51,85,92,15468,4642,1058,54,6,4,1919,51,34,7
2020-12-09T11:00:10.040020,52.5540583333,13.3661066667, none, sw,0.0056300550574976,51,85,92,15468,4642,1058,54,6,4,1919,51,34,7
2020-12-09T11:00:11.059486,52.554095,13.36609, none, sw,0.0056300550574976,51,84,90,15620,4656,1046,51,6,4,1919,51,33,6
2020-12-09T11:00:12.075181,52.554134999999995,13.366081666700001, none, sw,0.0056300550574976,52,87,96,15695,4684,1066,61,10,6,1919,52,35,9
2020-12-09T11:00:13.089899,52.5541716667,13.36607, none, sw,0.0056300550574976,52,85,93,15626,4656,1048,57,9,5,1919,52,33,8
2020-12-09T11:00:14.109128,52.5542116667,13.3660633333, none, sw,0.0056300550574976,53,87,96,15716,4702,1062,61,12,5,1919,53,34,9
2020-12-09T11:00:15.126348,52.55425,13.366055, none, sw,0.0056300550574976,54,87,97,16146,4872,1080,55,13,6,1919,54,33,10
2020-12-09T11:00:16.143259,52.55429,13.3660466667, none, sw,0.0056300550574976,55,88,99,16433,4914,1096,53,14,6,1919,55,33,11
2020-12-09T11:00:17.160726,52.5543283333,13.366038333299999, none, sw,0.0056300550574976,56,91,99,16469,4928,1108,53,13,5,1919,56,35,8
2020-12-09T11:00:18.179201,52.5543683333,13.366033333299999, none, s,0.0049750488491121,56,90,97,16188,4900,1110,51,11,5,1919,56,34,7
2020-12-09T11:00:19.195679,52.55441,13.366026666700002, none, s,0.0049750488491121,56,88,98,16445,4949,1076,53,12,6,1919,56,32,10
2020-12-09T11:00:20.216130,52.55445,13.3660216667, none, s,0.0049750488491121,55,85,95,16143,4894,1048,47,12,6,1919,55,30,10
2020-12-09T11:00:21.230817,52.5544916667,13.3660183333, none, s,0.0049750488491121,55,86,100,16409,4930,1050,54,15,7,1919,55,31,14
2020-12-09T11:00:22.248556,52.5545316667,13.3660133333, none, s,0.0049750488491121,57,85,94,16669,4965,1028,42,10,4,1919,57,28,9
2020-12-09T11:00:23.270516,52.5545716667,13.366005, none, s,0.0049750488491121,58,86,94,16726,4983,1040,42,10,4,1919,58,28,8
2020-12-09T11:00:24.287335,52.5546116667,13.365996666700001, none, s,0.0049750488491121,58,86,94,16726,4983,1040,42,10,4,1919,58,28,8
2020-12-09T11:00:25.305666,52.5546516667,13.36599, none, s,0.0049750488491121,57,84,93,16738,4973,1024,38,10,4,1919,57,27,9
2020-12-09T11:00:26.321888,52.5546933333,13.365991666700001, none, s,0.0051783045382987,56,83,92,16496,4949,888,38,10,3,1919,56,27,9
2020-12-09T11:00:27.339426,52.554735,13.36599, none, s,0.0051783045382987,54,82,89,16403,4919,1024,36,9,3,1919,54,28,7
2020-12-09T11:00:28.355924,52.5547733333,13.365986666700001, none, s,0.0051783045382987,55,83,94,16481,4945,894,46,10,4,1919,55,28,11
2020-12-09T11:00:29.371297,52.5548116667,13.365985, none, s,0.0051783045382987,55,83,94,16451,4937,892,46,9,3,1919,55,28,11
2020-12-09T11:00:30.387206,52.5548483333,13.365983333299999, none, s,0.0051783045382987,52,81,91,15659,4675,1024,50,9,3,1919,52,29,10
2020-12-09T11:00:31.403785,52.5548833333,13.3659783333, none, s,0.0051783045382987,53,82,92,15695,4686,1024,50,9,3,1919,53,29,10
2020-12-09T11:00:32.420405,52.554921666700004,13.3659783333, none, s,0.0051783045382987,52,81,88,15417,4636,1024,46,7,2,1919,52,29,7
2020-12-09T11:00:33.436234,52.5549616667,13.3659783333, none, s,0.0051783045382987,49,78,86,14700,4413,884,48,7,2,1919,49,29,8
2020-12-09T11:00:34.453524,52.5550016667,13.3659766667, none, s,0.0049000234118545,48,76,86,14365,4223,882,48,10,3,1919,48,28,10
2020-12-09T11:00:35.469395,52.5550433333,13.365975, none, s,0.0049000234118545,47,75,85,14347,4209,878,44,8,4,1919,47,28,10
2020-12-09T11:00:36.485906,52.5550833333,13.36597, none, s,0.0049000234118545,49,78,87,14852,4405,878,50,7,4,1919,49,29,9
2020-12-09T11:00:37.502548,52.5551233333,13.3659633333, none, s,0.0049000234118545,52,81,90,14852,4401,852,54,7,4,1919,52,29,9
2020-12-09T11:00:38.519053,52.5551633333,13.365960000000001, none, s,0.0049000234118545,49,76,84,14117,4166,812,46,7,4,1919,49,27,8
2020-12-09T11:00:39.535854,52.5552033333,13.3659566667, none, s,0.0049000234118545,47,72,83,13600,3951,798,48,8,5,1919,47,25,11
2020-12-09T11:00:40.552748,52.555240000000005,13.365951666700001, none, s,0.0049000234118545,45,70,79,13400,3923,788,44,7,4,1919,45,25,9
2020-12-09T11:00:41.569621,52.5552766667,13.365945000000002, none, s,0.0049000234118545,44,71,80,13382,3921,794,50,8,5,1919,44,27,9
2020-12-09T11:00:42.586158,52.5553116667,13.365943333299999, none, s,0.0049348840222306,45,72,80,13382,3933,798,50,7,5,1919,45,27,8
2020-12-09T11:00:43.608416,52.555346666700004,13.365935, none, s,0.0049348840222306,44,75,84,13424,3931,820,64,8,5,1919,44,31,9
2020-12-09T11:00:44.623785,52.555385,13.365929999999999, none, s,0.0049348840222306,43,75,81,13149,3884,796,62,5,4,1919,43,32,6
2020-12-09T11:00:45.648589,52.5554233333,13.3659166667, none, s,0.0049348840222306,40,73,84,12808,3699,792,72,9,8,1919,40,33,11
2020-12-09T11:00:46.667605,52.5554616667,13.365903333299999, none, s,0.0049348840222306,38,70,81,12139,3621,794,70,9,8,1919,38,32,11
2020-12-09T11:00:47.681325,52.5555,13.365893333299999, none, s,0.0049348840222306,36,69,82,11807,3436,814,70,12,8,1919,36,33,13
2020-12-09T11:00:48.699289,52.5555383333,13.365885, none, s,0.0049348840222306,38,70,82,12049,3594,828,68,11,7,1919,38,32,12
2020-12-09T11:00:49.715891,52.5555783333,13.3658816667, none, s,0.0049348840222306,39,71,82,12414,3653,830,66,10,6,1919,39,32,11
2020-12-09T11:00:50.739754,52.555618333299996,13.3658783333, none, s,0.0049116835895668,41,78,90,12859,3848,854,74,11,7,1919,41,37,12
2020-12-09T11:00:51.759061,52.5556583333,13.3658766667, none, s,0.0049116835895668,41,76,87,12826,3705,846,67,10,6,1919,41,35,11
2020-12-09T11:00:52.774683,52.5556966667,13.3658733333, none, s,0.0049116835895668,41,75,86,12838,3703,826,67,10,6,1919,41,34,11
2020-12-09T11:00:53.797940,52.5557333333,13.365865, none, s,0.0049116835895668,42,71,81,12874,3843,820,53,9,6,1919,42,29,10
2020-12-09T11:00:54.814050,52.555769999999995,13.365856666700001, none, s,0.0049116835895668,42,71,81,12874,3843,820,53,9,6,1919,42,29,10
2020-12-09T11:00:55.831753,52.5558066667,13.365848333299999, none, s,0.0049116835895668,43,76,86,13391,3930,856,59,10,6,1919,43,33,10
2020-12-09T11:00:56.845417,52.555845,13.365841666700002, none, s,0.0049116835895668,45,78,84,13932,4139,870,49,5,1,1919,45,33,6
2020-12-09T11:00:57.856190,52.5558816667,13.365839999999999, none, s,0.0049116835895668,45,78,83,14096,4143,874,45,5,1,1919,45,33,5
2020-12-09T11:00:58.880579,52.55591999999999,13.365845000000002, none, s,0.0048027756345504,46,80,83,14616,4208,872,45,2,1,1919,46,34,3
2020-12-09T11:00:59.897423,52.5559566667,13.365848333299999, none, s,0.0048027756345504,47,85,89,15109,4411,1028,53,3,2,1919,47,38,4
2020-12-09T11:01:00.914430,52.555994999999996,13.36585, none, s,0.0048027756345504,48,88,93,15127,4433,1062,55,6,2,1919,48,40,5
2020-12-09T11:01:01.931067,52.5560316667,13.365843333299999, none, s,0.0048027756345504,49,89,93,15205,4463,1070,49,6,2,1919,49,40,4
2020-12-09T11:01:02.948585,52.5560666667,13.3658316667, none, s,0.0048027756345504,50,91,97,15722,4672,1082,54,6,2,1919,50,41,6
2020-12-09T11:01:03.966730,52.5561033333,13.3658183333, none, s,0.0048027756345504,50,94,103,15910,4682,1118,66,9,2,1919,50,44,9
2020-12-09T11:01:04.983739,52.5561383333,13.365801666700001, none, s,0.0048027756345504,52,95,104,15916,4704,1130,70,9,2,1919,52,43,9
2020-12-09T11:01:05.999967,52.5561733333,13.365785, none, s,0.0048027756345504,50,93,104,15880,4692,1116,70,8,2,1919,50,43,11
2020-12-09T11:01:07.014698,52.5562116667,13.3657716667, none, s,0.0046869468680566,52,95,107,15985,4734,1132,74,9,3,1919,52,43,12
2020-12-09T11:01:09.029827,52.5563233333,13.365745, none, s,0.0046869468680566,53,95,106,15985,4732,1116,74,9,3,1919,53,42,11
2020-12-09T11:01:10.047952,52.55636,13.36573, none, s,0.0046869468680566,52,94,106,15731,4710,1112,76,9,3,1919,52,42,12
2020-12-09T11:01:11.057015,52.5563933333,13.365716666700001, none, s,0.0046869468680566,50,90,104,15372,4635,1110,72,11,5,1919,50,40,14
2020-12-09T11:01:12.080752,52.5564266667,13.365708333299999, none, s,0.0046869468680566,49,89,101,15130,4464,1090,76,9,6,1919,49,40,12
2020-12-09T11:01:13.095456,52.5564583333,13.3656966667, none, s,0.0046869468680566,48,86,98,14918,4424,1082,72,9,5,1919,48,38,12
2020-12-09T11:01:14.117534,52.5564866667,13.365689999999999, none, s,0.0044390008712077,46,85,97,14452,4219,1078,72,9,5,1919,46,39,12
2020-12-09T11:01:15.120392,52.556515000000005,13.3656833333, none, s,0.0044390008712077,46,84,94,14368,4207,1076,66,7,6,1919,46,38,10
2020-12-09T11:01:16.143042,52.5565416667,13.36568, none, s,0.0044390008712077,45,83,93,14138,4161,1066,66,7,6,1919,45,38,10
2020-12-09T11:01:17.160333,52.5565666667,13.3656783333, none, s,0.0044390008712077,45,84,93,14120,4147,1068,68,7,6,1919,45,39,9
2020-12-09T11:01:18.179100,52.556585,13.3656716667, none, s,0.0044390008712077,43,81,87,13427,3926,1040,66,6,5,1919,43,38,6
2020-12-09T11:01:19.195967,52.5566,13.365663333299999, none, s,0.0044390008712077,42,81,86,13179,3889,1036,66,6,5,1919,42,39,5
2020-12-09T11:01:20.214784,52.556615,13.36566, none, s,0.0044390008712077,42,78,87,13125,3883,1024,62,7,6,1919,42,36,9
2020-12-09T11:01:21.229593,52.5566266667,13.3656533333, none, s,0.0044390008712077,42,79,84,13065,3869,882,66,4,3,1919,42,37,5
2020-12-09T11:01:22.250266,52.5566383333,13.36565, none, s,0.0024400252419317,42,77,82,12877,3865,874,58,3,2,1919,42,35,5
2020-12-09T11:01:23.267424,52.5566483333,13.3656483333, none, s,0.0024400252419317,43,79,83,13095,3897,878,60,3,3,1919,43,36,4
2020-12-09T11:01:24.285242,52.5566533333,13.3656483333, none, s,0.0024400252419317,43,79,83,13095,3897,878,60,3,3,1919,43,36,4
2020-12-09T11:01:25.302028,52.5566583333,13.365656666700001, none, s,0.0024400252419317,42,76,81,12644,3711,858,58,3,3,1919,42,34,5
2020-12-09T11:01:26.319624,52.5566616667,13.365666666700001, none, s,0.0024400252419317,43,77,82,12892,3869,866,56,3,3,1919,43,34,5
2020-12-09T11:01:27.335649,52.5566666667,13.3656766667, none, s,0.0024400252419317,42,74,80,12593,3692,848,54,4,3,1919,42,32,6
2020-12-09T11:01:28.349881,52.55667,13.3656866667, none, s,0.0024400252419317,40,72,79,12094,3629,838,56,5,4,1919,40,32,7
2020-12-09T11:01:29.368166,52.5566716667,13.365695, none, s,0.0024400252419317,39,69,75,11583,3417,816,52,5,4,1919,39,30,6
2020-12-09T11:01:30.388623,52.556675,13.365706666700001, none, se,0.00079901877562719,37,68,78,11338,3391,804,58,10,9,1919,37,31,10
2020-12-09T11:01:31.405128,52.5566766667,13.365716666700001, none, se,0.00079901877562719,36,66,75,11045,3328,792,60,9,8,1919,36,30,9
2020-12-09T11:01:32.421553,52.5566783333,13.365725, none, se,0.00079901877562719,36,68,75,11093,3340,804,58,9,8,1919,36,32,7
2020-12-09T11:01:33.438395,52.55668000000001,13.3657333333, none, se,0.00079901877562719,36,66,75,11036,3196,800,56,9,8,1919,36,30,9
2020-12-09T11:01:34.458867,52.5566816667,13.365739999999999, none, se,0.00079901877562719,35,66,73,10597,3147,796,52,8,7,1919,35,31,7
2020-12-09T11:01:35.474209,52.5566833333,13.3657483333, none, se,0.00079901877562719,36,68,76,11018,3331,832,52,9,8,1919,36,32,8
2020-12-09T11:01:36.489928,52.5566833333,13.365753333299999, none, se,0.00079901877562719,35,68,76,10830,3189,832,58,11,8,1919,35,33,8
2020-12-09T11:01:37.505850,52.5566833333,13.365758333299999, none, se,0.00079901877562719,35,68,78,11039,3347,830,60,11,8,1919,35,33,10
2020-12-09T11:01:38.522210,52.5566833333,13.365763333299999, none, e,0.00056278984364553,36,66,76,11120,3365,810,52,10,7,1919,36,30,10
2020-12-09T11:01:39.537947,52.5566833333,13.365768333299998, none, e,0.00056278984364553,38,70,87,11777,3443,862,70,19,10,1919,38,32,17
2020-12-09T11:01:40.559986,52.5566833333,13.3657716667, none, e,0.00056278984364553,39,75,88,12294,3634,892,74,15,6,1919,39,36,13
2020-12-09T11:01:41.578459,52.556684999999995,13.3657766667, none, e,0.00056278984364553,39,76,89,12342,3658,1038,70,15,6,1919,39,37,13
2020-12-09T11:01:42.594165,52.556684999999995,13.365779999999999, none, e,0.00056278984364553,39,76,90,12369,3670,1046,70,16,7,1919,39,37,14
2020-12-09T11:01:43.609022,52.556684999999995,13.3657833333, none, e,0.00056278984364553,40,77,92,12668,3845,1054,70,16,7,1919,40,37,15
2020-12-09T11:01:44.630696,52.556684999999995,13.3657866667, none, e,0.00056278984364553,40,75,91,12414,3675,1040,74,19,8,1919,40,35,16
2020-12-09T11:01:45.647645,52.556684999999995,13.3657883333, none, e,0.00056278984364553,39,75,93,12363,3655,884,78,19,8,1919,39,36,18
2020-12-09T11:01:46.664396,52.5566833333,13.365789999999999, none, e,0.00025732437593085,39,71,88,12076,3596,848,70,16,7,1919,39,32,17
2020-12-09T11:01:47.681136,52.5566833333,13.3657933333, none, e,0.00025732437593085,39,72,88,12148,3613,862,66,15,7,1919,39,33,16
2020-12-09T11:01:48.697328,52.5566833333,13.3657933333, none, e,0.00025732437593085,40,77,90,12584,3668,884,66,15,7,1919,40,37,13
2020-12-09T11:01:49.714775,52.5566833333,13.365795, none, e,0.00025732437593085,43,80,87,13325,3912,888,54,6,4,1919,43,37,7
2020-12-09T11:01:50.730973,52.5566816667,13.365795, none, e,0.00025732437593085,43,79,85,13155,3922,884,46,5,3,1919,43,36,6
2020-12-09T11:01:51.748027,52.5566816667,13.365796666700001, none, e,0.00025732437593085,46,79,85,13618,4101,876,43,5,3,1919,46,33,6
2020-12-09T11:01:52.765184,52.55668000000001,13.365798333299999, none, e,0.00025732437593085,46,79,85,13618,4101,876,43,5,3,1919,46,33,6
2020-12-09T11:01:53.781550,52.55668000000001,13.365798333299999, none, e,0.00025732437593085,46,77,82,13415,3951,852,37,4,2,1919,46,31,5
2020-12-09T11:01:54.801355,52.55668000000001,13.365801666700001, none, e,0.0001242994825864,46,77,81,13415,3951,852,37,4,2,1919,46,31,4
2020-12-09T11:01:55.803404,52.5566783333,13.365803333299999, none, e,0.0001242994825864,46,78,83,13663,4113,866,39,5,3,1919,46,32,5
2020-12-09T11:01:56.825717,52.5566783333,13.365804999999998, none, e,0.0001242994825864,48,81,85,14174,4188,878,43,2,2,1919,48,33,4
2020-12-09T11:01:57.842183,52.5566783333,13.365804999999998, none, e,0.0001242994825864,49,84,86,14691,4391,890,43,2,2,1919,49,35,2
2020-12-09T11:01:58.857874,52.5566783333,13.365804999999998, none, e,0.0001242994825864,51,85,90,15166,4458,1038,47,5,3,1919,51,34,5
2020-12-09T11:01:59.881310,52.5566783333,13.365806666700001, none, e,0.0001242994825864,54,87,92,15659,4679,1030,49,6,3,1919,54,33,5
2020-12-09T11:02:00.898445,52.5566766667,13.365806666700001, none, e,0.0001242994825864,55,87,92,15910,4713,1024,44,6,3,1919,55,32,5
2020-12-09T11:02:01.915292,52.556675,13.365806666700001, none, e,0.0001242994825864,55,87,93,15874,4702,1034,48,7,3,1919,55,32,6
2020-12-09T11:02:02.932507,52.556675,13.365808333299999, none, ne,0.00010149010254288001,56,91,96,16427,4909,1050,50,7,3,1919,56,35,5
2020-12-09T11:02:03.949940,52.5566766667,13.365808333299999, none, ne,0.00010149010254288001,59,94,100,16962,5140,1060,53,7,3,1919,59,35,6
2020-12-09T11:02:04.966571,52.5566766667,13.365808333299999, none, ne,0.00010149010254288001,64,102,108,18471,5486,1106,55,7,3,1919,64,38,6
2020-12-09T11:02:05.984186,52.5566766667,13.365806666700001, none, ne,0.00010149010254288001,66,103,108,18958,5695,1084,53,6,2,1919,66,37,5
2020-12-09T11:02:07.000934,52.55668000000001,13.365804999999998, none, ne,0.00010149010254288001,68,106,113,19723,5944,1102,55,7,2,1919,68,38,7
2020-12-09T11:02:08.018602,52.5566816667,13.365803333299999, none, ne,0.00010149010254288001,71,110,116,20052,6000,1122,55,7,2,1919,71,39,6
2020-12-09T11:02:10.035668,52.5566616667,13.365825, none, ne,0.0002657634726809,71,110,116,20052,6000,1122,55,7,2,1919,71,39,6
2020-12-09T11:02:11.053191,52.55665,13.365839999999999, none, ne,0.0002657634726809,70,110,113,20010,5982,1110,49,4,1,1919,70,40,3
2020-12-09T11:02:12.070164,52.556635,13.365854999999998, none, ne,0.0002657634726809,68,106,110,19553,5897,1122,49,3,1,1919,68,38,4
2020-12-09T11:02:13.086681,52.556623333299996,13.365870000000001, none, ne,0.0002657634726809,66,104,109,19206,5705,1116,52,4,2,1919,66,38,5
2020-12-09T11:02:14.105647,52.5566133333,13.3658816667, none, ne,0.0002657634726809,64,100,106,18543,5487,1082,50,6,3,1919,64,36,6
2020-12-09T11:02:15.111858,52.556605000000005,13.365891666700001, none, ne,0.0002657634726809,61,97,105,17966,5398,1080,56,7,3,1919,61,36,8
2020-12-09T11:02:16.129609,52.5565983333,13.3659, none, ne,0.0002657634726809,57,95,102,17153,5134,1088,56,8,3,1919,57,38,7
2020-12-09T11:02:17.147023,52.5565933333,13.3659066667, none, ne,0.0002657634726809,55,91,99,16185,4869,1062,54,8,3,1919,55,36,8
2020-12-09T11:02:18.164111,52.55659,13.3659116667, none, ne,0.0014129428185929997,52,87,95,15668,4652,1058,53,8,3,1919,52,35,8
2020-12-09T11:02:19.181324,52.5565883333,13.3659133333, none, ne,0.0014129428185929997,50,84,91,14891,4395,1038,51,8,4,1919,50,34,7
2020-12-09T11:02:20.198590,52.55659,13.365915, none, ne,0.0014129428185929997,47,81,87,14144,4183,1026,47,8,3,1919,47,34,6
2020-12-09T11:02:21.215206,52.5565983333,13.365905, none, ne,0.0014129428185929997,48,82,88,14362,4223,1036,45,8,3,1919,48,34,6
2020-12-09T11:02:22.232937,52.5566066667,13.365896666700001, none, ne,0.0014129428185929997,48,82,91,14344,4367,1026,49,11,3,1919,48,34,9
2020-12-09T11:02:23.249587,52.5566166667,13.365886666700002, none, ne,0.0014129428185929997,48,81,92,14168,4354,1032,51,13,2,1919,48,33,11
2020-12-09T11:02:24.267043,52.556623333299996,13.365879999999999, none, ne,0.0014129428185929997,48,81,92,14168,4354,1032,51,13,2,1919,48,33,11
2020-12-09T11:02:25.283185,52.5566316667,13.3658716667, none, ne,0.0014129428185929997,48,79,88,14084,4201,892,43,10,1,1919,48,31,9
2020-12-09T11:02:26.299427,52.5566433333,13.365865, none, sw,0.00095956655036375,48,79,88,14084,4201,892,43,10,1,1919,48,31,9
2020-12-09T11:02:27.315628,52.55666,13.365854999999998, none, sw,0.00095956655036375,48,79,88,14120,4195,890,43,10,2,1919,48,31,9
2020-12-09T11:02:28.331684,52.5566816667,13.365848333299999, none, sw,0.00095956655036375,47,78,87,13869,4157,872,49,10,2,1919,47,31,9
2020-12-09T11:02:29.349446,52.5567083333,13.365841666700002, none, sw,0.00095956655036375,44,74,86,13352,3954,852,53,11,2,1919,44,30,12
2020-12-09T11:02:30.365458,52.5567366667,13.3658333333, none, sw,0.00095956655036375,43,76,87,13098,3912,868,60,11,2,1919,43,33,11
2020-12-09T11:02:31.381896,52.55676999999999,13.3658266667, none, sw,0.00095956655036375,44,78,89,13627,4126,882,58,11,1,1919,44,34,11
2020-12-09T11:02:32.398654,52.5568066667,13.3658166667, none, sw,0.00095956655036375,46,79,89,13609,4112,856,60,11,1,1919,46,33,10
2020-12-09T11:02:33.415191,52.5568416667,13.365804999999998, none, sw,0.00095956655036375,44,78,89,13173,3913,858,66,12,1,1919,44,34,11
2020-12-09T11:02:34.431644,52.55688000000001,13.3657933333, none, s,0.0038226120911952,44,79,92,13319,3905,864,72,14,6,1919,44,35,13
2020-12-09T11:02:35.448124,52.5569183333,13.3657866667, none, s,0.0038226120911952,43,79,91,13179,3897,874,74,12,7,1919,43,36,12
2020-12-09T11:02:36.464682,52.556955,13.3657783333, none, s,0.0038226120911952,42,81,93,13146,3885,888,78,12,7,1919,42,39,12
2020-12-09T11:02:37.481186,52.5569916667,13.3657666667, none, s,0.0038226120911952,42,79,91,13158,3905,876,68,11,6,1919,42,37,12
2020-12-09T11:02:38.498198,52.557026666700004,13.365758333299999, none, s,0.0038226120911952,43,82,91,13391,3935,888,66,10,6,1919,43,39,9
2020-12-09T11:02:39.517097,52.5570633333,13.365751666700001, none, s,0.0038226120911952,45,84,95,13648,4102,1046,70,12,9,1919,45,39,11
2020-12-09T11:02:40.520285,52.5571016667,13.3657416667, none, s,0.0038226120911952,45,84,95,13648,4102,1046,70,12,9,1919,45,39,11
2020-12-09T11:02:41.540776,52.557138333299996,13.3657316667, none, s,0.0038226120911952,43,84,94,13436,3951,1048,66,13,9,1919,43,41,10
2020-12-09T11:02:42.558608,52.557175,13.3657216667, none, s,0.0047369124015612,43,84,94,13436,3951,1048,66,13,9,1919,43,41,10
2020-12-09T11:02:43.574762,52.5572116667,13.36571, none, s,0.0047369124015612,42,79,90,12859,3865,1032,59,12,9,1919,42,37,11
2020-12-09T11:02:44.589862,52.5572483333,13.3657, none, s,0.0047369124015612,42,79,90,12859,3865,1032,59,12,9,1919,42,37,11
2020-12-09T11:02:45.609051,52.5572866667,13.365695, none, s,0.0047369124015612,42,79,90,13065,3879,1042,55,11,9,1919,42,37,11
2020-12-09T11:02:46.625585,52.5573216667,13.3656916667, none, s,0.0047369124015612,42,79,90,13065,3879,1042,55,11,9,1919,42,37,11
2020-12-09T11:02:47.641944,52.5573566667,13.3656833333, none, s,0.0047369124015612,42,81,91,13119,3910,1048,51,11,10,1919,42,39,10
2020-12-09T11:02:48.658605,52.5573933333,13.365675, none, s,0.0047369124015612,42,81,91,13119,3910,1048,51,11,10,1919,42,39,10
2020-12-09T11:02:49.675339,52.557430000000004,13.365668333299999, none, s,0.0047369124015612,41,76,82,12859,3859,1024,37,7,5,1919,41,35,6
2020-12-09T11:02:50.691628,52.5574633333,13.36566, none, s,0.0046187156943001,41,77,84,12865,3872,1032,41,7,4,1919,41,36,7
2020-12-09T11:02:51.708316,52.557496666700004,13.365651666700002, none, s,0.0046187156943001,42,78,86,13164,3927,1038,45,7,4,1919,42,36,8
2020-12-09T11:02:52.724236,52.5575316667,13.3656433333, none, s,0.0046187156943001,42,79,86,13364,3927,1036,49,7,4,1919,42,37,7
2020-12-09T11:02:53.740864,52.5575666667,13.3656366667, none, s,0.0046187156943001,41,78,86,13400,3933,1042,47,8,4,1919,41,37,8
2020-12-09T11:02:54.756786,52.5576033333,13.3656316667, none, s,0.0046187156943001,41,77,83,13334,3912,1024,41,5,1,1919,41,36,6
2020-12-09T11:02:55.773747,52.5576383333,13.3656266667, none, s,0.0046187156943001,41,78,83,13382,3925,1024,41,5,1,1919,41,37,5
2020-12-09T11:02:56.789800,52.5576733333,13.365620000000002, none, s,0.0046187156943001,41,79,84,13406,3935,884,46,5,1,1919,41,38,5
2020-12-09T11:02:57.806279,52.5577066667,13.365613333299999, none, s,0.0046187156943001,41,80,85,13358,3939,1032,50,5,1,1919,41,39,5
2020-12-09T11:02:58.823372,52.557741666700004,13.365606666700002, none, s,0.0044512282645133,41,80,84,13158,3915,892,52,4,0,1919,41,39,4
2020-12-09T11:02:59.839976,52.5577733333,13.3656, none, s,0.0044512282645133,42,82,87,13430,4098,1040,56,3,0,1919,42,40,5
2020-12-09T11:03:00.856715,52.557805,13.3655966667, none, s,0.0044512282645133,43,78,84,13424,3957,890,48,2,0,1919,43,35,6
2020-12-09T11:03:01.874636,52.5578366667,13.3655883333, none, s,0.0044512282645133,42,76,81,13170,3924,892,40,2,0,1919,42,34,5
2020-12-09T11:03:02.891156,52.5578666667,13.365578333299998, none, s,0.0044512282645133,42,76,81,13170,3924,892,40,2,0,1919,42,34,5
2020-12-09T11:03:03.908439,52.5578983333,13.365570000000002, none, s,0.0044512282645133,42,74,78,12898,3900,892,36,2,0,1919,42,32,4
2020-12-09T11:03:04.926607,52.557930000000006,13.365565, none, s,0.0044512282645133,42,74,78,12898,3900,892,36,2,0,1919,42,32,4
2020-12-09T11:03:05.942732,52.5579633333,13.365561666700001, none, s,0.0044512282645133,44,76,80,13056,3909,886,36,1,0,1919,44,32,4
2020-12-09T11:03:06.960236,52.557995,13.36556, none, s,0.0040493515288109,44,76,80,13056,3909,886,36,1,0,1919,44,32,4
2020-12-09T11:03:07.977234,52.5580283333,13.365554999999999, none, s,0.0040493515288109,44,74,79,12895,3899,878,38,2,1,1919,44,30,5
2020-12-09T11:03:08.994336,52.55806,13.36555, none, s,0.0040493515288109,45,77,84,13355,3963,888,48,4,4,1919,45,32,7
2020-12-09T11:03:10.013325,52.5580933333,13.365545000000001, none, s,0.0040493515288109,45,75,84,13319,3947,892,48,5,4,1919,45,30,9
2020-12-09T11:03:12.030046,52.558184999999995,13.365515, none, s,0.0040493515288109,44,74,84,13137,3912,868,48,8,7,1919,44,30,10
2020-12-09T11:03:13.049693,52.558213333299996,13.3655, none, s,0.0040493515288109,45,73,83,13331,3932,856,48,8,7,1919,45,28,10
2020-12-09T11:03:14.056252,52.55824499999999,13.3654916667, none, s,0.0040256852271818,43,72,82,13059,3887,842,46,8,7,1919,43,29,10
2020-12-09T11:03:15.077827,52.558275,13.365478333299999, none, s,0.0040256852271818,43,75,84,13161,3914,874,46,8,7,1919,43,32,9
2020-12-09T11:03:16.094967,52.558303333299996,13.365464999999999, none, s,0.0040256852271818,46,80,90,13615,4099,884,60,11,8,1919,46,34,10
2020-12-09T11:03:17.111651,52.5583316667,13.36545, none, s,0.0040256852271818,46,83,96,13645,4099,892,68,14,9,1919,46,37,13
2020-12-09T11:03:18.128331,52.5583616667,13.3654366667, none, s,0.0040256852271818,48,84,97,14105,4159,1030,70,14,9,1919,48,36,13
2020-12-09T11:03:19.145994,52.558391666700004,13.365414999999999, none, s,0.0040256852271818,48,88,99,14356,4202,1044,72,13,8,1919,48,40,11
2020-12-09T11:03:20.161633,52.5584233333,13.3654, none, s,0.0040256852271818,47,82,93,13890,4138,894,62,10,5,1919,47,35,11
2020-12-09T11:03:21.179074,52.5584566667,13.365379999999998, none, s,0.0040256852271818,47,88,97,14102,4164,1048,74,9,5,1919,47,41,9
2020-12-09T11:03:22.195475,52.5584866667,13.3653633333, none, sw,0.0040339922055319,48,89,98,14150,4191,1054,76,9,3,1919,48,41,9
2020-12-09T11:03:23.212209,52.5585166667,13.365345000000001, none, sw,0.0040339922055319,46,89,97,13869,4142,1068,74,9,3,1919,46,43,8
2020-12-09T11:03:24.235117,52.5585466667,13.365331666700001, none, sw,0.0040339922055319,46,89,97,13869,4142,1068,74,9,3,1919,46,43,8
2020-12-09T11:03:25.252501,52.558575,13.3653183333, none, sw,0.0040339922055319,47,89,97,13887,4154,1076,72,9,3,1919,47,42,8
2020-12-09T11:03:26.270231,52.5586,13.3653, none, sw,0.0040339922055319,47,89,97,13887,4154,1076,72,9,3,1919,47,42,8
2020-12-09T11:03:27.287757,52.55863000000001,13.365283333299999, none, sw,0.0040339922055319,47,87,96,13887,4156,1056,69,9,3,1919,47,40,9
2020-12-09T11:03:28.296373,52.558659999999996,13.3652683333, none, sw,0.0040339922055319,47,87,96,13887,4156,1056,69,9,3,1919,47,40,9
2020-12-09T11:03:29.319137,52.558690000000006,13.365248333299999, none, sw,0.0040339922055319,46,85,91,13633,4130,1036,61,7,2,1919,46,39,6
2020-12-09T11:03:30.336463,52.5587216667,13.365231666700002, none, sw,0.0039435887611952,46,85,92,13633,4130,1036,61,7,2,1919,46,39,7
2020-12-09T11:03:31.359223,52.5587516667,13.3652166667, none, sw,0.0039435887611952,43,78,84,12671,3864,858,53,5,2,1919,43,35,6
2020-12-09T11:03:32.377599,52.558780000000006,13.3652, none, sw,0.0039435887611952,40,72,77,11882,3619,830,46,5,2,1919,40,32,5
2020-12-09T11:03:33.393531,52.5588116667,13.365191666700001, none, sw,0.0039435887611952,39,70,77,11810,3586,822,46,6,3,1919,39,31,7
2020-12-09T11:03:34.418389,52.5588416667,13.3651783333, none, sw,0.0039435887611952,39,71,77,11607,3435,824,50,6,3,1919,39,32,6
2020-12-09T11:03:35.415078,52.5588716667,13.365165, none, sw,0.0039435887611952,39,68,76,11619,3435,820,40,9,4,1919,39,29,8
2020-12-09T11:03:36.440064,52.558905,13.36515, none, sw,0.0039435887611952,38,65,72,11308,3370,816,36,6,3,1919,38,27,7
2020-12-09T11:03:37.457607,52.5589366667,13.365135, none, sw,0.0039435887611952,37,63,70,11090,3340,804,38,6,3,1919,37,26,7
2020-12-09T11:03:38.480829,52.5589666667,13.365115, none, sw,0.0040516447307363,37,65,74,11320,3353,814,46,7,4,1919,37,28,9
2020-12-09T11:03:39.498677,52.558996666700004,13.365098333299999, none, sw,0.0040516447307363,37,69,81,11550,3387,836,59,12,5,1919,37,32,12
2020-12-09T11:03:40.503792,52.559025,13.365085, none, sw,0.0040516447307363,36,71,83,11350,3358,840,65,12,6,1919,36,35,12
2020-12-09T11:03:41.524829,52.5590533333,13.3650683333, none, sw,0.0040516447307363,40,76,92,12142,3618,1030,75,14,8,1919,40,36,16
2020-12-09T11:03:42.541348,52.5590833333,13.365051666700001, none, sw,0.0040516447307363,42,81,99,12575,3685,1048,86,17,11,1919,42,39,18
2020-12-09T11:03:43.558654,52.559115000000006,13.3650433333, none, sw,0.0040516447307363,42,80,97,12390,3679,1042,82,16,10,1919,42,38,17
2020-12-09T11:03:44.574441,52.5591466667,13.3650283333, none, sw,0.0040516447307363,41,78,96,12360,3655,1026,86,16,10,1919,41,37,18
2020-12-09T11:03:45.598061,52.5591783333,13.365011666700001, none, sw,0.0040516447307363,40,78,93,12118,3622,1024,88,13,9,1919,40,38,15
2020-12-09T11:03:46.619934,52.5592116667,13.364996666700002, none, sw,0.0040561592259086,41,78,97,12348,3654,1026,92,16,10,1919,41,37,19
2020-12-09T11:03:47.637005,52.559245,13.364985, none, sw,0.0040561592259086,43,81,98,12841,3863,1034,88,17,10,1919,43,38,17
2020-12-09T11:03:48.654248,52.5592816667,13.364975, none, sw,0.0040561592259086,45,83,99,13182,3929,1032,88,16,9,1919,45,38,16
2020-12-09T11:03:49.678277,52.5593166667,13.364968333299998, none, sw,0.0040561592259086,45,83,94,13116,3923,892,82,11,8,1919,45,38,11
2020-12-09T11:03:50.700804,52.559355000000004,13.3649666667, none, sw,0.0040561592259086,46,79,98,13358,3948,878,78,19,10,1919,46,33,19
2020-12-09T11:03:51.716522,52.559394999999995,13.36498, none, sw,0.0040561592259086,45,78,92,13418,3952,852,70,16,7,1919,45,33,14
2020-12-09T11:03:52.733640,52.5594333333,13.3649933333, none, sw,0.0040561592259086,45,78,88,13424,3946,858,62,13,4,1919,45,33,10
2020-12-09T11:03:53.749384,52.5594716667,13.365004999999998, none, sw,0.0040561592259086,48,83,96,14132,4169,888,72,14,5,1919,48,35,13
2020-12-09T11:03:54.766087,52.559509999999996,13.3650183333, none, s,0.0047436639573257,50,86,98,14619,4388,1032,64,14,5,1919,50,36,12
2020-12-09T11:03:55.782841,52.5595466667,13.365025, none, s,0.0047436639573257,50,86,98,14861,4423,1028,62,14,5,1919,50,36,12
2020-12-09T11:03:56.799008,52.559585,13.365029999999999, none, s,0.0047436639573257,50,87,97,14867,4433,1036,62,12,4,1919,50,37,10
2020-12-09T11:03:57.816265,52.559621666700004,13.365035, none, s,0.0047436639573257,50,88,97,14849,4423,1036,64,11,4,1919,50,38,9
2020-12-09T11:03:58.831481,52.5596583333,13.3650366667, none, s,0.0047436639573257,50,88,97,14849,4423,1036,64,11,4,1919,50,38,9
2020-12-09T11:03:59.848694,52.5596933333,13.3650333333, none, s,0.0047436639573257,49,85,95,14362,4365,1050,56,12,4,1919,49,36,10
2020-12-09T11:04:00.866891,52.55973,13.3650266667, none, s,0.0047436639573257,49,85,95,14362,4365,1050,56,12,4,1919,49,36,10
2020-12-09T11:04:01.883003,52.5597666667,13.365020000000001, none, s,0.0047436639573257,49,83,96,14398,4355,1052,52,15,5,1919,49,34,13
2020-12-09T11:04:02.899883,52.559805000000004,13.365020000000001, none, s,0.0046861030537566,49,83,96,14398,4355,1052,52,15,5,1919,49,34,13
2020-12-09T11:04:03.916636,52.559844999999996,13.365020000000001, none, s,0.0046861030537566,48,85,92,14144,4198,1074,52,7,3,1919,48,37,7
2020-12-09T11:04:04.933913,52.559884999999994,13.365020000000001, none, s,0.0046861030537566,48,85,92,14144,4198,1074,52,7,3,1919,48,37,7
2020-12-09T11:04:05.950693,52.559925,13.3650216667, none, s,0.0046861030537566,49,89,96,14380,4382,1104,58,7,3,1919,49,40,7
2020-12-09T11:04:06.967708,52.559965000000005,13.3650233333, none, s,0.0046861030537566,50,93,101,14604,4404,1130,64,10,3,1919,50,43,8
2020-12-09T11:04:07.985589,52.560005000000004,13.3650266667, none, s,0.0046861030537566,48,89,97,14147,4210,1106,58,9,2,1919,48,41,8
2020-12-09T11:04:09.002385,52.5600416667,13.3650283333, none, s,0.0046861030537566,45,88,97,13570,4109,1106,64,10,3,1919,45,43,9
2020-12-09T11:04:10.017216,52.560080000000006,13.3650266667, none, s,0.0046861030537566,45,87,98,13570,3967,1090,68,15,3,1919,45,42,11
2020-12-09T11:04:14.040592,52.560271666700004,13.365013333299999, none, s,0.0074132696923882,47,88,99,13941,4162,1096,62,14,3,1919,47,41,11
2020-12-09T11:04:15.044994,52.5603083333,13.36501, none, s,0.0074132696923882,47,90,102,14365,4218,1104,62,15,3,1919,47,43,12
2020-12-09T11:04:16.064685,52.560345,13.365006666700001, none, s,0.0074132696923882,48,88,98,14395,4220,1076,61,14,3,1919,48,40,10
2020-12-09T11:04:17.083899,52.5603816667,13.365003333299999, none, s,0.0074132696923882,47,87,96,14087,4183,1072,59,11,2,1919,47,40,9
2020-12-09T11:04:18.094588,52.56041999999999,13.365001666700001, none, s,0.0074132696923882,48,90,98,14371,4360,1080,59,10,1,1919,48,42,8
2020-12-09T11:04:19.109813,52.5604566667,13.365, none, s,0.0074132696923882,46,85,94,13830,4135,1050,55,10,1,1919,46,39,9
2020-12-09T11:04:20.124944,52.560494999999996,13.364996666700002, none, s,0.0074132696923882,43,78,85,13065,3877,864,47,7,1,1919,43,35,7
2020-12-09T11:04:21.144653,52.5605333333,13.3649933333, none, s,0.0074132696923882,43,78,85,13107,3887,886,43,7,1,1919,43,35,7
2020-12-09T11:04:22.154633,52.5605733333,13.364989999999999, none, s,0.004797257667488,44,79,85,13343,3929,1028,37,6,0,1919,44,35,6
2020-12-09T11:04:23.178987,52.5606116667,13.3649883333, none, s,0.004797257667488,43,79,80,13107,3906,1026,27,1,0,1919,43,36,1
2020-12-09T11:04:24.196179,52.56065,13.3649883333, none, s,0.004797257667488,43,79,80,13107,3906,1026,27,1,0,1919,43,36,1
2020-12-09T11:04:25.213034,52.5606916667,13.3649833333, none, s,0.004797257667488,43,77,78,12635,3851,880,29,1,0,1919,43,34,1
2020-12-09T11:04:26.231095,52.56073000000001,13.3649816667, none, s,0.004797257667488,43,77,78,12635,3851,880,29,1,0,1919,43,34,1
2020-12-09T11:04:27.247839,52.56077,13.3649766667, none, s,0.004797257667488,41,74,76,12127,3650,878,31,1,0,1919,41,33,2
2020-12-09T11:04:28.264677,52.56081,13.3649666667, none, s,0.004797257667488,41,74,76,12127,3650,878,31,1,0,1919,41,33,2
2020-12-09T11:04:29.281161,52.5608483333,13.364958333299999, none, s,0.004797257667488,41,75,79,12309,3658,1028,34,1,0,1919,41,34,4
2020-12-09T11:04:30.299449,52.5608866667,13.364951666700001, none, s,0.0049910316488152,41,76,80,12309,3658,1028,34,1,0,1919,41,35,4
2020-12-09T11:04:31.316001,52.560925,13.3649483333, none, s,0.0049910316488152,42,77,82,12387,3679,890,40,2,0,1919,42,35,5
2020-12-09T11:04:32.332265,52.5609633333,13.364945, none, s,0.0049910316488152,42,77,82,12387,3679,890,40,2,0,1919,42,35,5
2020-12-09T11:04:33.348422,52.5609983333,13.3649383333, none, s,0.0049910316488152,40,71,76,11852,3592,844,34,2,0,1919,40,31,5
2020-12-09T11:04:34.364936,52.561035,13.3649283333, none, s,0.0049910316488152,41,72,78,12103,3625,864,34,3,0,1919,41,31,6
2020-12-09T11:04:35.381370,52.5610683333,13.364920000000001, none, s,0.0049910316488152,42,77,83,12381,3694,894,42,4,0,1919,42,35,6
2020-12-09T11:04:36.397321,52.561105000000005,13.36491, none, s,0.0049910316488152,41,77,83,12133,3663,874,50,5,0,1919,41,36,6
2020-12-09T11:04:37.414049,52.56114,13.3648966667, none, s,0.0049910316488152,40,75,82,12157,3657,860,54,6,0,1919,40,35,7
2020-12-09T11:04:38.417231,52.5611733333,13.3648816667, none, s,0.0046035779143848,39,76,83,11882,3605,874,62,6,0,1919,39,37,7
2020-12-09T11:04:39.438753,52.5612066667,13.364865, none, s,0.0046035779143848,39,78,85,11870,3599,892,62,6,0,1919,39,39,7
2020-12-09T11:04:40.455208,52.5612416667,13.3648483333, none, s,0.0046035779143848,38,78,86,11843,3443,876,64,6,1,1919,38,40,8
2020-12-09T11:04:41.471780,52.5612733333,13.36483, none, s,0.0046035779143848,37,77,86,11386,3398,858,70,7,2,1919,37,40,9
2020-12-09T11:04:42.499049,52.561305000000004,13.364815, none, s,0.0046035779143848,36,75,86,11269,3355,850,72,11,2,1919,36,39,11
2020-12-09T11:04:43.507793,52.5613383333,13.3648033333, none, s,0.0046035779143848,37,76,90,11386,3391,872,76,12,2,1919,37,39,14
2020-12-09T11:04:44.529466,52.5613733333,13.3647933333, none, s,0.0046035779143848,35,75,87,11299,3374,842,76,12,3,1919,35,40,12
2020-12-09T11:04:45.545763,52.5614066667,13.3647816667, none, s,0.0046035779143848,35,74,86,11317,3380,832,74,11,3,1919,35,39,12
2020-12-09T11:04:46.563045,52.561440000000005,13.364776666700001, none, s,0.004355657956476,35,74,86,11317,3380,832,74,11,3,1919,35,39,12
2020-12-09T11:04:47.579129,52.561475,13.364773333299999, none, s,0.004355657956476,34,69,83,11012,3194,818,64,11,4,1919,34,35,14
2020-12-09T11:04:48.594971,52.5615066667,13.364771666700001, none, s,0.004355657956476,34,68,79,10594,3146,804,60,10,4,1919,34,34,11
2020-12-09T11:04:49.610997,52.56154,13.364770000000002, none, s,0.004355657956476,34,66,77,10564,3132,784,58,10,4,1919,34,32,11
2020-12-09T11:04:50.628005,52.561575,13.364768333299999, none, s,0.004355657956476,32,61,73,10023,2914,620,56,10,4,1919,32,29,12
2020-12-09T11:04:51.639865,52.561609999999995,13.364770000000002, none, s,0.004355657956476,31,56,67,9476,2837,588,49,9,3,1919,31,25,11
2020-12-09T11:04:52.654847,52.5616466667,13.364770000000002, none, s,0.004355657956476,30,52,60,9022,2641,568,40,8,2,1919,30,22,8
2020-12-09T11:04:53.680185,52.561683333299996,13.364770000000002, none, s,0.004355657956476,29,51,55,8786,2615,550,36,3,2,1919,29,22,4
2020-12-09T11:04:54.696848,52.561719999999994,13.364768333299999, none, s,0.0044485208616323,27,51,53,8541,2571,542,34,2,2,1919,27,24,2
2020-12-09T11:04:55.718391,52.5617566667,13.364766666700001, none, s,0.0044485208616323,26,47,51,8233,2371,532,34,2,1,1919,26,21,4
2020-12-09T11:04:56.738026,52.5617916667,13.364766666700001, none, s,0.0044485208616323,25,44,47,7761,2174,516,30,2,1,1919,25,19,3
2020-12-09T11:04:57.751935,52.56183000000001,13.364765, none, s,0.0044485208616323,25,46,53,7967,2332,538,40,6,1,1919,25,21,7
2020-12-09T11:04:58.770343,52.5618666667,13.364770000000002, none, s,0.0044485208616323,24,46,53,7713,2171,532,44,6,1,1919,24,22,7
2020-12-09T11:04:59.788120,52.5619016667,13.364778333299999, none, s,0.0044485208616323,23,44,50,7429,2122,514,40,6,1,1919,23,21,6
2020-12-09T11:05:00.804168,52.5619366667,13.364785000000001, none, s,0.0044485208616323,23,44,50,7429,2122,514,40,6,1,1919,23,21,6
2020-12-09T11:05:01.820423,52.561969999999995,13.3647866667, none, s,0.0044485208616323,24,45,53,7489,2136,524,46,7,1,1919,24,21,8
2020-12-09T11:05:02.838304,52.5619983333,13.36479, none, s,0.0044262618483629,25,48,58,7794,2319,556,51,8,2,1919,25,23,10
2020-12-09T11:05:03.855804,52.5620233333,13.36479, none, s,0.0044262618483629,25,50,61,7988,2337,566,56,11,5,1919,25,25,11
2020-12-09T11:05:04.873003,52.5620483333,13.36478, none, s,0.0044262618483629,24,50,62,7770,2171,574,58,12,6,1919,24,26,12
2020-12-09T11:05:05.889640,52.56208,13.364770000000002, none, s,0.0044262618483629,24,47,61,7546,2145,562,56,13,7,1919,24,23,14
2020-12-09T11:05:06.902537,52.56211,13.364765, none, s,0.0044262618483629,24,50,63,7740,2313,586,54,13,8,1919,24,26,13
2020-12-09T11:05:07.905747,52.5621416667,13.3647583333, none, s,0.0044262618483629,25,51,64,8018,2350,592,54,13,8,1919,25,26,13
2020-12-09T11:05:08.925096,52.5621733333,13.3647516667, none, s,0.0044262618483629,25,49,60,7776,2314,572,48,11,8,1919,25,24,11
2020-12-09T11:05:09.948541,52.5622033333,13.3647483333, none, s,0.0044262618483629,26,50,63,8206,2355,580,46,12,9,1919,26,24,13
2020-12-09T11:05:10.965480,52.5622316667,13.3647433333, none, s,0.0037338152173536,29,52,65,8765,2570,600,46,12,9,1919,29,23,13
2020-12-09T11:05:11.981742,52.5622583333,13.3647383333, none, s,0.0037338152173536,30,56,68,9506,2663,612,52,11,9,1919,30,26,12
2020-12-09T11:05:12.998998,52.5622816667,13.364733333299998, none, s,0.0037338152173536,30,53,67,9294,2631,602,52,10,8,1919,30,23,14
2020-12-09T11:05:14.016385,52.5623066667,13.364731666700001, none, s,0.0037338152173536,29,52,64,9022,2590,582,50,8,6,1919,29,23,12
2020-12-09T11:05:16.034827,52.5623816667,13.3647116667, none, s,0.0037338152173536,29,52,64,9022,2590,582,50,8,6,1919,29,23,12
2020-12-09T11:05:17.051411,52.5624033333,13.36471, none, s,0.0037338152173536,29,50,59,8810,2577,562,43,7,5,1919,29,21,9
2020-12-09T11:05:18.074434,52.5624283333,13.3647033333, none, s,0.0031478296903479,29,50,59,8810,2577,562,43,7,5,1919,29,21,9
2020-12-09T11:05:19.099857,52.5624466667,13.3646916667, none, s,0.0031478296903479,29,50,59,8780,2571,564,40,6,4,1919,29,21,9
2020-12-09T11:05:20.105676,52.562465,13.3646866667, none, s,0.0031478296903479,29,50,59,8780,2571,564,40,6,4,1919,29,21,9
2020-12-09T11:05:21.125817,52.5624833333,13.364679999999998, none, s,0.0031478296903479,26,45,53,8251,2348,518,37,5,3,1919,26,19,8
2020-12-09T11:05:22.149105,52.5625,13.364670000000002, none, s,0.0031478296903479,26,44,53,8203,2334,516,39,6,4,1919,26,18,9
2020-12-09T11:05:23.165842,52.562515000000005,13.3646616667, none, s,0.0031478296903479,26,45,53,8251,2336,514,41,4,3,1919,26,19,8
2020-12-09T11:05:24.182889,52.56253,13.3646483333, none, s,0.0031478296903479,25,42,51,7979,2174,368,41,4,3,1919,25,17,9
2020-12-09T11:05:25.200886,52.5625433333,13.364629999999998, none, s,0.0031478296903479,24,42,52,7710,2156,362,43,7,4,1919,24,18,10
2020-12-09T11:05:26.218358,52.56254499999999,13.3646, none, sw,0.0021048057369585,23,40,53,7429,2119,512,41,12,5,1919,23,17,13
2020-12-09T11:05:27.234592,52.562540000000006,13.3645666667, none, sw,0.0021048057369585,23,42,53,7477,2129,512,39,12,5,1919,23,19,11
2020-12-09T11:05:28.257262,52.562540000000006,13.364535, none, sw,0.0021048057369585,25,45,58,8015,2336,532,45,12,4,1919,25,20,13
2020-12-09T11:05:29.276972,52.562535,13.3645066667, none, sw,0.0021048057369585,26,50,64,8738,2431,552,58,12,4,1919,26,24,14
2020-12-09T11:05:30.292922,52.5625266667,13.3644766667, none, sw,0.0021048057369585,28,52,69,8992,2585,558,71,15,7,1919,28,24,17
2020-12-09T11:05:31.307816,52.5625166667,13.364443333299999, none, sw,0.0021048057369585,29,55,74,9303,2636,586,78,16,8,1919,29,26,19
2020-12-09T11:05:32.328750,52.5625083333,13.3644166667, none, sw,0.0021048057369585,29,55,74,9521,2660,578,74,16,8,1919,29,26,19
2020-12-09T11:05:33.340297,52.5625033333,13.3644, none, sw,0.0021048057369585,30,55,71,9479,2662,570,70,16,9,1919,30,25,16
2020-12-09T11:05:34.363412,52.562490000000004,13.36439, none, w,0.0022080137554201,30,55,71,9479,2662,570,70,16,9,1919,30,25,16
2020-12-09T11:05:35.374663,52.562475,13.3643833333, none, w,0.0022080137554201,31,57,73,9823,2848,610,66,15,8,1919,31,26,16
2020-12-09T11:05:36.397250,52.5624483333,13.364375, none, w,0.0022080137554201,31,57,73,9823,2848,610,66,15,8,1919,31,26,16
2020-12-09T11:05:37.418218,52.5624133333,13.3643733333, none, w,0.0022080137554201,30,57,70,9829,2836,606,62,12,7,1919,30,27,13
2020-12-09T11:05:38.434601,52.5623816667,13.364379999999999, none, w,0.0022080137554201,30,57,70,9829,2836,606,62,12,7,1919,30,27,13
2020-12-09T11:05:39.450685,52.5623483333,13.3643833333, none, w,0.0022080137554201,29,52,62,9315,2629,546,52,7,6,1919,29,23,10
2020-12-09T11:05:40.466624,52.5623166667,13.36439, none, w,0.0022080137554201,29,53,63,9297,2637,550,54,8,6,1919,29,24,10
2020-12-09T11:05:41.482997,52.562286666700004,13.364398333299999, none, w,0.0022080137554201,29,50,62,8801,2570,542,52,10,9,1919,29,21,12
2020-12-09T11:05:42.498910,52.5622583333,13.3644116667, none, n,0.0036859714637458,27,48,58,8460,2380,544,44,10,9,1919,27,21,10
2020-12-09T11:05:43.515098,52.562235,13.3644233333, none, n,0.0036859714637458,28,50,57,8753,2562,550,36,8,6,1919,28,22,7
2020-12-09T11:05:44.531383,52.5622166667,13.364435, none, n,0.0036859714637458,30,51,60,9073,2630,548,32,8,6,1919,30,21,9
2020-12-09T11:05:45.547462,52.5622033333,13.364448333299999, none, n,0.0036859714637458,30,53,60,9073,2632,562,32,7,5,1919,30,23,7
2020-12-09T11:05:46.563600,52.5621833333,13.364465, none, n,0.0036859714637458,31,55,63,9524,2682,586,34,9,5,1919,31,24,8
2020-12-09T11:05:47.579424,52.5621616667,13.3644733333, none, n,0.0036859714637458,31,55,63,9476,2676,572,36,10,6,1919,31,24,8
2020-12-09T11:05:48.595725,52.56214,13.3644783333, none, n,0.0036859714637458,32,57,65,9554,2832,582,42,10,6,1919,32,25,8
2020-12-09T11:05:49.611662,52.562125,13.364486666700001, none, n,0.0036859714637458,34,61,69,10020,2895,610,46,10,6,1919,34,27,8
2020-12-09T11:05:50.628573,52.5620966667,13.364485, none, ne,0.0026639253225489,34,61,69,10244,2911,622,46,9,6,1919,34,27,8
2020-12-09T11:05:51.647776,52.5620733333,13.364483333299999, none, ne,0.0026639253225489,36,64,70,10815,3139,778,42,7,3,1919,36,28,6
2020-12-09T11:05:52.668840,52.5620466667,13.364486666700001, none, ne,0.0026639253225489,36,64,70,10815,3139,778,42,7,3,1919,36,28,6
2020-12-09T11:05:53.684733,52.562025,13.36449, none, ne,0.0026639253225489,37,63,69,10863,3145,772,37,7,3,1919,37,26,6
2020-12-09T11:05:54.700721,52.562,13.364498333299998, none, ne,0.0026639253225489,40,67,71,11586,3356,788,41,6,3,1919,40,27,4
2020-12-09T11:05:55.717163,52.561980000000005,13.3645033333, none, ne,0.0026639253225489,40,68,73,11825,3387,802,38,5,2,1919,40,28,5
2020-12-09T11:05:56.733976,52.56196,13.3645083333, none, ne,0.0026639253225489,38,67,70,11589,3345,792,40,5,2,1919,38,29,3
2020-12-09T11:05:57.757764,52.5619466667,13.3645116667, none, ne,0.0026639253225489,36,62,64,11021,3126,624,36,2,1,1919,36,26,2
2020-12-09T11:05:58.778437,52.5619316667,13.3645216667, none, n,0.0026448695702643,34,60,62,10609,2923,602,36,2,1,1919,34,26,2
2020-12-09T11:05:59.794562,52.5619266667,13.364533333299999, none, n,0.0026448695702643,35,58,62,10773,2933,604,32,3,2,1919,35,23,4
2020-12-09T11:06:00.810654,52.5619166667,13.364541666700001, none, n,0.0026448695702643,32,55,63,10086,2844,596,36,10,5,1919,32,23,8
2020-12-09T11:06:01.826487,52.5619,13.36455, none, n,0.0026448695702643,30,53,61,9551,2639,568,36,10,5,1919,30,23,8
2020-12-09T11:06:02.843379,52.5618833333,13.3645666667, none, n,0.0026448695702643,28,49,57,9076,2418,528,38,10,5,1919,28,21,8
2020-12-09T11:06:03.859642,52.5618566667,13.364581666700001, none, n,0.0026448695702643,25,45,54,8487,2321,376,39,10,5,1919,25,20,9
2020-12-09T11:06:04.876472,52.5618466667,13.364593333299998, none, n,0.0026448695702643,21,37,47,6966,1867,334,33,11,6,1919,21,16,10
2020-12-09T11:06:05.893231,52.56182,13.3646033333, none, n,0.0026448695702643,18,33,43,6213,1633,308,34,11,6,1919,18,15,10
2020-12-09T11:06:06.910053,52.561795,13.3646083333, none, ne,0.0023266165275229998,18,33,43,6213,1633,308,34,11,6,1919,18,15,10
2020-12-09T11:06:07.928044,52.5617783333,13.364614999999999, none, ne,0.0023266165275229998,17,30,42,5989,1604,296,34,12,6,1919,17,13,12
2020-12-09T11:06:08.944829,52.5617466667,13.3646116667, none, ne,0.0023266165275229998,17,30,42,5989,1604,296,34,12,6,1919,17,13,12
2020-12-09T11:06:09.961175,52.56171,13.3646033333, none, ne,0.0023266165275229998,17,29,41,5729,1570,296,33,12,6,1919,17,12,12
2020-12-09T11:06:10.977496,52.5616633333,13.3646033333, none, ne,0.0023266165275229998,17,29,41,5729,1570,296,33,12,6,1919,17,12,12
2020-12-09T11:06:11.997264,52.5616183333,13.364605, none, ne,0.0023266165275229998,18,29,41,5747,1597,288,33,12,5,1919,18,11,12
2020-12-09T11:06:13.018362,52.561555000000006,13.364626666700001, none, ne,0.0023266165275229998,18,29,41,5747,1597,288,33,12,5,1919,18,11,12
2020-12-09T11:06:15.037659,52.5613516667,13.364718333299999, none, n,0.0071219941484508,15,24,36,5122,1354,126,33,14,5,1919,15,9,12
2020-12-09T11:06:16.056786,52.5612983333,13.364735000000001, none, n,0.0071219941484508,15,24,36,5122,1354,126,33,14,5,1919,15,9,12
2020-12-09T11:06:17.077562,52.5612533333,13.3647483333, none, n,0.0071219941484508,16,28,36,5463,1405,266,35,8,2,1919,16,12,8
2020-12-09T11:06:18.100034,52.5612066667,13.364761666700002, none, n,0.0071219941484508,15,25,34,5215,1367,126,30,8,2,1919,15,10,9
2020-12-09T11:06:19.117888,52.5611633333,13.364776666700001, none, n,0.0071219941484508,16,27,35,5209,1395,276,30,8,3,1919,16,11,8
2020-12-09T11:06:20.135073,52.561125,13.3647883333, none, n,0.0071219941484508,16,27,35,5209,1399,280,29,8,3,1919,16,11,8
2020-12-09T11:06:21.152144,52.5610816667,13.3648016667, none, n,0.0071219941484508,16,28,35,5185,1387,286,33,7,2,1919,16,12,7
2020-12-09T11:06:22.169088,52.5610433333,13.364813333299999, none, n,0.0071219941484508,15,27,35,5140,1367,282,33,7,2,1919,15,12,8
2020-12-09T11:06:23.186733,52.561009999999996,13.364821666700001, none, n,0.0055183264248617,16,27,36,5164,1381,282,33,9,3,1919,16,11,9
2020-12-09T11:06:24.205168,52.56097,13.364828333299998, none, n,0.0055183264248617,17,30,39,5493,1564,288,36,9,3,1919,17,13,9
2020-12-09T11:06:25.220660,52.5609266667,13.364835000000001, none, n,0.0055183264248617,16,29,37,5430,1547,290,34,8,3,1919,16,13,8
2020-12-09T11:06:26.237175,52.5608883333,13.3648383333, none, n,0.0055183264248617,17,30,36,5502,1577,292,31,5,2,1919,17,13,6
2020-12-09T11:06:27.254116,52.5608466667,13.36484, none, n,0.0055183264248617,18,30,34,5684,1609,272,25,5,2,1919,18,12,4
2020-12-09T11:06:28.270654,52.5608033333,13.3648416667, none, n,0.0055183264248617,21,34,39,6249,1838,296,25,5,2,1919,21,13,5
2020-12-09T11:06:29.288116,52.5607633333,13.3648433333, none, n,0.0055183264248617,20,30,34,5896,1633,272,23,4,1,1919,20,10,4
2020-12-09T11:06:30.304990,52.560725,13.3648483333, none, n,0.0055183264248617,20,30,35,5920,1637,272,23,4,1,1919,20,10,5
2020-12-09T11:06:31.310219,52.560685,13.3648533333, none, n,0.0051716758337662,21,33,36,6407,1822,290,21,4,1,1919,21,12,3
2020-12-09T11:06:32.328640,52.5606433333,13.3648533333, none, n,0.0051716758337662,22,34,37,6470,1838,300,23,4,1,1919,22,12,3
2020-12-09T11:06:33.349593,52.5606016667,13.364854999999999, none, n,0.0051716758337662,21,34,35,6494,1834,302,21,1,0,1919,21,13,1
2020-12-09T11:06:34.362752,52.5605616667,13.364858333299999, none, n,0.0051716758337662,21,35,36,6518,1842,324,19,1,0,1919,21,14,1
2020-12-09T11:06:35.383444,52.5605283333,13.364865, none, n,0.0051716758337662,22,37,40,6715,1867,344,21,2,1,1919,22,15,3
2020-12-09T11:06:36.403847,52.5604933333,13.364871666700001, none, n,0.0051716758337662,21,38,40,6685,1847,346,24,2,1,1919,21,17,2
2020-12-09T11:06:37.419069,52.5604583333,13.3648783333, none, n,0.0051716758337662,20,36,39,6431,1805,352,22,1,1,1919,20,16,3
2020-12-09T11:06:38.435147,52.5604233333,13.364885000000001, none, n,0.0051716758337662,19,36,41,6407,1659,350,29,4,2,1919,19,17,5
2020-12-09T11:06:39.452110,52.5603866667,13.3648933333, none, n,0.0047547405127572,21,44,48,7181,1912,520,35,4,2,1919,21,23,4
2020-12-09T11:06:40.468508,52.5603483333,13.3649, none, n,0.0047547405127572,24,52,58,8063,2328,568,44,5,2,1919,24,28,6
2020-12-09T11:06:41.484484,52.56031,13.36491, none, n,0.0047547405127572,26,54,60,8281,2380,582,46,6,3,1919,26,28,6
2020-12-09T11:06:42.499505,52.560269999999996,13.364916666700001, none, n,0.0047547405127572,28,57,64,8822,2599,598,44,7,3,1919,28,29,7
2020-12-09T11:06:43.516327,52.5602333333,13.364923333299998, none, n,0.0047547405127572,32,63,70,9563,2849,636,48,7,3,1919,32,31,7
2020-12-09T11:06:44.525533,52.5601916667,13.3649283333, none, n,0.0047547405127572,32,64,75,9793,2875,778,58,12,4,1919,32,32,11
2020-12-09T11:06:45.545191,52.5601516667,13.364935000000001, none, n,0.0047547405127572,32,64,73,9745,2860,770,60,11,3,1919,32,32,9
2020-12-09T11:06:46.566637,52.560115,13.3649416667, none, n,0.0047547405127572,34,69,79,10092,3073,804,64,11,3,1919,34,35,10
2020-12-09T11:06:47.582408,52.5600783333,13.36495, none, n,0.0049283571103516,38,73,84,10845,3190,854,64,11,3,1919,38,35,11
2020-12-09T11:06:48.597310,52.560035,13.36495, none, n,0.0049283571103516,40,79,87,11828,3455,1030,58,8,2,1919,40,39,8
2020-12-09T11:06:49.613209,52.5599966667,13.364956666700001, none, n,0.0049283571103516,41,80,86,12076,3614,1024,52,8,2,1919,41,39,6
2020-12-09T11:06:50.627980,52.55996,13.364963333299999, none, n,0.0049283571103516,41,80,86,12076,3614,1024,52,8,2,1919,41,39,6
2020-12-09T11:06:51.638382,52.5599233333,13.364970000000001, none, n,0.0049283571103516,41,77,84,12052,3608,884,50,7,2,1919,41,36,7
2020-12-09T11:06:52.656304,52.559884999999994,13.3649783333, none, n,0.0049283571103516,41,77,84,12052,3608,884,50,7,2,1919,41,36,7
2020-12-09T11:06:53.671036,52.559844999999996,13.364985, none, n,0.0049283571103516,42,76,89,12151,3628,886,52,13,6,1919,42,34,13
2020-12-09T11:06:54.687686,52.5598066667,13.364995, none, n,0.0049283571103516,42,76,89,12151,3628,886,52,13,6,1919,42,34,13
2020-12-09T11:06:55.703792,52.5597683333,13.365004999999998, none, n,0.0049529279421501,42,77,89,12327,3632,892,52,12,6,1919,42,35,12
2020-12-09T11:06:56.720533,52.5597316667,13.365013333299999, none, n,0.0049529279421501,42,77,89,12327,3632,892,52,12,6,1919,42,35,12
2020-12-09T11:06:57.725227,52.5596933333,13.3650216667, none, n,0.0049529279421501,41,73,85,11852,3443,862,48,12,6,1919,41,32,12
2020-12-09T11:06:58.733446,52.5596566667,13.365035, none, n,0.0049529279421501,41,73,85,11852,3443,862,48,12,6,1919,41,32,12
2020-12-09T11:06:59.758835,52.559621666700004,13.365051666700001, none, n,0.0049529279421501,44,75,84,12363,3660,864,40,8,5,1919,44,31,9
2020-12-09T11:07:00.774333,52.5595866667,13.365070000000001, none, n,0.0049529279421501,46,78,88,13062,3885,882,40,9,5,1919,46,32,10
2020-12-09T11:07:01.793923,52.55955,13.3650866667, none, n,0.0049529279421501,47,78,89,13379,3931,878,40,9,5,1919,47,31,11
2020-12-09T11:07:02.804962,52.5595166667,13.365103333299999, none, n,0.0049529279421501,47,76,92,13337,3921,860,44,14,10,1919,47,29,16
2020-12-09T11:07:03.827539,52.5594833333,13.3651166667, none, n,0.0046538852209131,46,75,92,13059,3875,848,46,15,10,1919,46,29,17
2020-12-09T11:07:04.843167,52.5594466667,13.3651216667, none, n,0.0046538852209131,45,75,93,12901,3861,856,48,16,10,1919,45,30,18
2020-12-09T11:07:05.858413,52.55941,13.3651233333, none, n,0.0046538852209131,45,75,92,12883,3844,864,48,16,10,1919,45,30,17
2020-12-09T11:07:06.873316,52.5593733333,13.365125, none, n,0.0046538852209131,46,77,88,13107,3875,872,44,10,6,1919,46,31,11
2020-12-09T11:07:07.888635,52.559335,13.3651266667, none, n,0.0046538852209131,46,80,92,13349,3898,1034,50,11,6,1919,46,34,12
2020-12-09T11:07:08.909847,52.5592966667,13.365135, none, n,0.0046538852209131,48,85,99,13830,3959,1062,64,16,7,1919,48,37,14
2020-12-09T11:07:09.914989,52.559259999999995,13.365143333299999, none, n,0.0046538852209131,45,82,98,13325,3878,1050,66,16,7,1919,45,37,16
2020-12-09T11:07:10.923370,52.559219999999996,13.365146666700001, none, n,0.0046538852209131,44,84,99,13331,3862,1060,70,16,7,1919,44,40,15
2020-12-09T11:07:11.943102,52.559180000000005,13.365151666700001, none, n,0.0048303089962622,43,82,96,13110,3696,1044,64,16,7,1919,43,39,14
2020-12-09T11:07:12.958676,52.5591366667,13.3651566667, none, n,0.0048303089962622,40,81,93,12805,3625,1038,68,14,2,1919,40,41,12
2020-12-09T11:07:13.974414,52.5590983333,13.365160000000001, none, n,0.0048303089962622,41,81,92,12659,3627,884,68,13,2,1919,41,40,11
2020-12-09T11:07:14.989606,52.559063333299996,13.365165, none, n,0.0048303089962622,41,81,92,12659,3627,884,68,13,2,1919,41,40,11
2020-12-09T11:07:16.010793,52.55903000000001,13.36517, none, n,0.0048303089962622,42,80,90,12665,3631,872,63,12,2,1919,42,38,10
2020-12-09T11:07:20.028887,52.5588316667,13.365195000000002, none, n,0.0055490722059857,42,80,90,12665,3631,872,63,12,2,1919,42,38,10
2020-12-09T11:07:21.040851,52.5587916667,13.3652016667, none, n,0.0055490722059857,43,80,91,12865,3666,864,59,13,2,1919,43,37,11
2020-12-09T11:07:22.063402,52.55875,13.365210000000001, none, n,0.0055490722059857,43,80,91,12865,3666,864,59,13,2,1919,43,37,11
2020-12-09T11:07:23.079853,52.5587116667,13.3652166667, none, n,0.0055490722059857,44,81,91,13059,3686,870,55,12,1,1919,44,37,10
2020-12-09T11:07:24.098023,52.5586733333,13.36522, none, n,0.0055490722059857,44,81,91,13059,3686,870,55,12,1,1919,44,37,10
2020-12-09T11:07:25.102027,52.558638333299996,13.3652266667, none, n,0.0055490722059857,43,80,89,12629,3661,844,53,12,1,1919,43,37,9
2020-12-09T11:07:26.110911,52.5586016667,13.365235, none, n,0.0055490722059857,43,80,89,12629,3661,844,53,12,1,1919,43,37,9
2020-12-09T11:07:27.132667,52.558565,13.365243333299999, none, n,0.0055490722059857,41,75,81,12088,3454,822,38,7,0,1919,41,34,6
2020-12-09T11:07:28.150117,52.558528333299996,13.36525, none, n,0.0048476418782718,41,73,79,12040,3432,808,34,7,0,1919,41,32,6
2020-12-09T11:07:29.166965,52.5584933333,13.365255, none, n,0.0048476418782718,42,73,79,11849,3434,806,34,7,1,1919,42,31,6
2020-12-09T11:07:30.185087,52.5584583333,13.365255, none, n,0.0048476418782718,40,72,78,11529,3392,808,34,7,1,1919,40,32,6
2020-12-09T11:07:31.202389,52.558425,13.365255, none, n,0.0048476418782718,42,74,78,11628,3432,814,32,4,1,1919,42,32,4
2020-12-09T11:07:32.220607,52.558391666700004,13.3652566667, none, n,0.0048476418782718,40,74,78,11383,3411,826,32,4,1,1919,40,34,4
2020-12-09T11:07:33.239057,52.5583566667,13.3652566667, none, n,0.0048476418782718,42,75,79,11329,3405,840,35,4,1,1919,42,33,4
2020-12-09T11:07:34.256198,52.558319999999995,13.3652616667, none, n,0.0048476418782718,39,74,79,11281,3376,844,39,6,1,1919,39,35,5
2020-12-09T11:07:35.273427,52.55828,13.3652683333, none, n,0.0048476418782718,39,74,79,11111,3344,830,45,6,1,1919,39,35,5
2020-12-09T11:07:36.290219,52.5582433333,13.365275, none, n,0.0045336460836047,39,75,81,11377,3377,840,47,6,1,1919,39,36,6
2020-12-09T11:07:37.307068,52.5582066667,13.365279999999998, none, n,0.0045336460836047,42,78,84,12034,3586,844,50,6,1,1919,42,36,6
2020-12-09T11:07:38.323139,52.558168333299996,13.365285, none, n,0.0045336460836047,44,82,87,12357,3648,864,54,5,1,1919,44,38,5
2020-12-09T11:07:39.339343,52.558130000000006,13.36529, none, n,0.0045336460836047,44,82,87,12566,3662,870,56,5,0,1919,44,38,5
2020-12-09T11:07:40.354865,52.5580916667,13.3652966667, none, n,0.0045336460836047,44,82,87,12566,3662,870,56,5,0,1919,44,38,5
2020-12-09T11:07:41.370645,52.5580516667,13.365305, none, n,0.0045336460836047,46,86,93,13095,3864,1024,62,6,1,1919,46,40,7
2020-12-09T11:07:42.386389,52.558009999999996,13.3653116667, none, n,0.0045336460836047,45,85,91,12856,3710,888,62,6,1,1919,45,40,6
2020-12-09T11:07:43.402458,52.557968333299996,13.3653183333, none, n,0.0045336460836047,43,81,88,12390,3628,862,64,6,1,1919,43,38,7
2020-12-09T11:07:44.421105,52.5579316667,13.365325, none, n,0.0049743093727786,40,79,85,12085,3435,834,68,6,1,1919,40,39,6
2020-12-09T11:07:45.424874,52.557894999999995,13.365333333299999, none, n,0.0049743093727786,39,75,80,11586,3375,806,62,4,1,1919,39,36,5
2020-12-09T11:07:46.432447,52.5578583333,13.36534, none, n,0.0049743093727786,37,68,74,10582,3111,774,56,5,1,1919,37,31,6
2020-12-09T11:07:47.453697,52.5578233333,13.36535, none, n,0.0049743093727786,37,68,72,10558,3115,772,54,4,1,1919,37,31,4
2020-12-09T11:07:48.467313,52.557784999999996,13.365355, none, n,0.0049743093727786,34,64,69,9829,2880,628,54,5,2,1919,34,30,5
2020-12-09T11:07:49.489087,52.5577516667,13.3653616667, none, n,0.0049743093727786,32,60,66,9306,2666,604,52,5,2,1919,32,28,6
2020-12-09T11:07:50.504678,52.5577183333,13.3653633333, none, n,0.0049743093727786,27,50,55,8230,2365,547,41,4,2,1919,27,23,5
2020-12-09T11:07:51.520940,52.5576833333,13.36536, none, n,0.0049743093727786,25,47,50,7525,2146,521,37,4,2,1919,25,22,3
2020-12-09T11:07:52.537097,52.5576466667,13.365355, none, n,0.0045364648660379,24,42,46,7253,2096,365,29,4,2,1919,24,18,4
2020-12-09T11:07:53.553101,52.557615000000006,13.365355, none, n,0.0045364648660379,27,48,52,8006,2339,545,31,5,3,1919,27,21,4
2020-12-09T11:07:54.569308,52.5575816667,13.365355, none, n,0.0045364648660379,28,49,56,8469,2403,569,31,8,6,1919,28,21,7
2020-12-09T11:07:55.585700,52.55755,13.3653516667, none, n,0.0045364648660379,30,53,61,8810,2591,585,37,8,7,1919,30,23,8
2020-12-09T11:07:56.600848,52.5575216667,13.3653516667, none, n,0.0045364648660379,30,53,61,8810,2591,585,37,8,7,1919,30,23,8
2020-12-09T11:07:57.617262,52.557496666700004,13.3653516667, none, n,0.0045364648660379,32,55,65,9237,2644,601,39,8,8,1919,32,23,10
2020-12-09T11:07:58.633087,52.5574733333,13.365355, none, n,0.0045364648660379,27,49,60,8281,2376,559,39,9,9,1919,27,22,11
2020-12-09T11:07:59.649719,52.557453333299996,13.36536, none, n,0.0045364648660379,27,48,56,8245,2343,547,36,8,8,1919,27,21,8
2020-12-09T11:08:00.665985,52.5574333333,13.3653633333, none, n,0.0033897325271341,27,50,60,8257,2357,561,42,9,9,1919,27,23,10
2020-12-09T11:08:01.681457,52.5574133333,13.3653666667, none, n,0.0033897325271341,31,56,66,9228,2622,604,45,9,9,1919,31,25,10
2020-12-09T11:08:02.697618,52.55739499999999,13.3653683333, none, n,0.0033897325271341,34,60,71,9841,2862,624,49,9,8,1919,34,26,11
2020-12-09T11:08:03.713351,52.55738,13.365371666700002, none, n,0.0033897325271341,36,66,77,10522,3083,790,57,10,8,1919,36,30,11
2020-12-09T11:08:04.729011,52.5573666667,13.365375, none, n,0.0033897325271341,38,67,79,10794,3137,784,57,12,8,1919,38,29,12
2020-12-09T11:08:05.744987,52.557355,13.365378333299999, none, n,0.0033897325271341,39,73,84,11269,3344,816,65,10,6,1919,39,34,11
2020-12-09T11:08:06.761101,52.5573483333,13.365383333299999, none, n,0.0033897325271341,42,78,87,11870,3443,850,65,9,5,1919,42,36,9
2020-12-09T11:08:07.777157,52.5573383333,13.365385, none, n,0.0033897325271341,45,83,93,12892,3846,874,69,8,4,1919,45,38,10
2020-12-09T11:08:08.793810,52.5573283333,13.365383333299999, none, n,0.0016790840016229999,49,89,100,13920,4136,1042,71,8,3,1919,49,40,11
2020-12-09T11:08:09.809148,52.55732,13.365385, none, n,0.0016790840016229999,53,95,106,14709,4416,1086,72,8,3,1919,53,42,11
2020-12-09T11:08:10.825904,52.55731,13.365386666700001, none, n,0.0016790840016229999,53,95,106,14709,4416,1086,72,8,3,1919,53,42,11
2020-12-09T11:08:11.841596,52.5572983333,13.365388333299999, none, n,0.0016790840016229999,55,96,106,15202,4618,1086,66,7,2,1919,55,41,10
2020-12-09T11:08:12.858553,52.5572883333,13.36539, none, n,0.0016790840016229999,55,96,106,15202,4618,1086,66,7,2,1919,55,41,10
2020-12-09T11:08:13.875291,52.5572783333,13.3653916667, none, n,0.0016790840016229999,56,100,110,15641,4693,1102,72,8,3,1919,56,44,10
2020-12-09T11:08:14.891367,52.557269999999995,13.365395000000001, none, n,0.0016790840016229999,54,100,108,15166,4626,1090,74,7,3,1919,54,46,8
2020-12-09T11:08:15.908252,52.557265,13.365395000000001, none, n,0.0016790840016229999,54,97,106,15106,4475,1074,74,6,3,1919,54,43,9
2020-12-09T11:08:16.924635,52.5572566667,13.3653933333, none, n,0.0011424481039083,49,90,97,14093,4194,1034,70,3,2,1919,49,41,7
2020-12-09T11:08:17.940953,52.55725,13.36539, none, n,0.0011424481039083,47,84,90,13418,3963,864,56,2,1,1919,47,37,6
2020-12-09T11:08:18.957852,52.5572366667,13.365383333299999, none, n,0.0011424481039083,45,79,87,12823,3864,844,54,5,2,1919,45,34,8
2020-12-09T11:08:19.974029,52.557228333299996,13.365379999999998, none, n,0.0011424481039083,41,71,81,11374,3410,802,50,8,5,1919,41,30,10
2020-12-09T11:08:20.990643,52.5572183333,13.365375, none, n,0.0011424481039083,37,66,73,10573,3153,634,43,7,5,1919,37,29,7
2020-12-09T11:08:22.008472,52.557205,13.365373333299999, none, n,0.0011424481039083,37,65,73,10361,3126,624,47,7,5,1919,37,28,8
2020-12-09T11:08:23.023941,52.557190000000006,13.365373333299999, none, n,0.0011424481039083,38,67,76,10755,3155,772,49,8,5,1919,38,29,9
2020-12-09T11:08:25.040286,52.5571283333,13.365388333299999, none, n,0.0020391592557903,37,65,76,10537,3125,624,51,8,5,1919,37,28,11
2020-12-09T11:08:26.056688,52.5571,13.3653966667, none, n,0.0020391592557903,41,66,77,11266,3352,630,47,9,5,1919,41,25,11
2020-12-09T11:08:27.073580,52.557069999999996,13.3654083333, none, n,0.0020391592557903,43,71,88,11855,3595,804,59,14,6,1919,43,28,17
2020-12-09T11:08:28.090178,52.55704,13.36542, none, n,0.0020391592557903,47,77,93,12871,3864,832,59,14,6,1919,47,30,16
2020-12-09T11:08:29.106597,52.5570083333,13.365429999999998, none, n,0.0020391592557903,47,78,99,12883,3880,830,73,19,7,1919,47,31,21
2020-12-09T11:08:30.122581,52.5569766667,13.36544, none, n,0.0020391592557903,47,78,99,12883,3880,830,73,19,7,1919,47,31,21
2020-12-09T11:08:31.139200,52.5569416667,13.3654466667, none, n,0.0020391592557903,47,80,99,13119,3919,836,71,17,7,1919,47,33,19
2020-12-09T11:08:32.156207,52.5569083333,13.3654533333, none, n,0.0020391592557903,47,80,99,13119,3919,836,71,17,7,1919,47,33,19
2020-12-09T11:08:33.172228,52.5568716667,13.36546, none, n,0.0041354659441243,49,81,99,13624,4112,856,71,15,4,1919,49,32,18
2020-12-09T11:08:34.188865,52.5568366667,13.365464999999999, none, n,0.0041354659441243,49,82,100,13618,4102,866,74,15,4,1919,49,33,18
2020-12-09T11:08:35.204934,52.556803333299996,13.365475, none, n,0.0041354659441243,45,77,95,12907,3867,838,72,15,4,1919,45,32,18
2020-12-09T11:08:36.221580,52.55676999999999,13.365485000000001, none, n,0.0041354659441243,41,71,88,12037,3587,790,67,14,4,1919,41,30,17
2020-12-09T11:08:37.237689,52.556734999999996,13.365495000000001, none, n,0.0041354659441243,39,68,83,11269,3329,636,59,14,3,1919,39,29,15
2020-12-09T11:08:38.254782,52.5566983333,13.3655066667, none, n,0.0041354659441243,36,67,83,10564,3110,770,63,14,4,1919,36,31,16
2020-12-09T11:08:39.271135,52.5566666667,13.365520000000002, none, n,0.0041354659441243,33,61,73,9754,2835,608,49,12,4,1919,33,28,12
2020-12-09T11:08:40.287571,52.5566333333,13.365535000000001, none, n,0.0041354659441243,30,57,70,9016,2612,592,53,13,4,1919,30,27,13
2020-12-09T11:08:41.303426,52.5565966667,13.3655483333, none, n,0.0044508770151458,29,55,65,8789,2574,604,43,8,3,1919,29,26,10
2020-12-09T11:08:42.319757,52.5565616667,13.3655583333, none, n,0.0044508770151458,25,52,60,8200,2327,570,43,7,2,1919,25,27,8
2020-12-09T11:08:43.336613,52.5565233333,13.365566666700001, none, n,0.0044508770151458,25,52,61,8230,2343,560,49,7,2,1919,25,27,9
2020-12-09T11:08:44.355103,52.5564916667,13.365578333299998, none, n,0.0044508770151458,26,54,63,8556,2401,570,49,7,2,1919,26,28,9
2020-12-09T11:08:45.357952,52.5564566667,13.3655883333, none, n,0.0044508770151458,27,55,65,9028,2576,588,49,7,2,1919,27,28,10
2020-12-09T11:08:46.378302,52.556419999999996,13.3655933333, none, n,0.0044508770151458,27,55,65,9028,2576,588,49,7,2,1919,27,28,10
2020-12-09T11:08:47.403750,52.556385,13.3656, none, n,0.0044508770151458,29,58,66,9279,2619,598,49,7,2,1919,29,29,8
2020-12-09T11:08:48.419335,52.5563466667,13.365606666700002, none, n,0.0044508770151458,29,58,66,9279,2619,598,49,7,2,1919,29,29,8
2020-12-09T11:08:49.433022,52.556309999999996,13.365615, none, n,0.0045989808711185,31,59,68,9742,2678,616,47,6,2,1919,31,28,9
2020-12-09T11:08:50.452860,52.556275,13.3656266667, none, n,0.0045989808711185,31,59,68,9742,2678,616,47,6,2,1919,31,28,9
2020-12-09T11:08:51.468571,52.5562366667,13.3656366667, none, n,0.0045989808711185,31,58,65,9760,2680,604,39,5,1,1919,31,27,7
2020-12-09T11:08:52.494289,52.5562,13.3656483333, none, n,0.0045989808711185,31,58,65,9760,2680,604,39,5,1,1919,31,27,7
2020-12-09T11:08:53.509983,52.5561616667,13.36566, none, n,0.0045989808711185,32,59,65,9841,2852,616,41,3,1,1919,32,27,6
2020-12-09T11:08:54.527563,52.5561233333,13.365673333299998, none, n,0.0045989808711185,32,59,64,9987,2846,614,37,2,1,1919,32,27,5
2020-12-09T11:08:55.543441,52.556084999999996,13.365685000000001, none, n,0.0045989808711185,32,57,60,9993,2838,578,33,2,1,1919,32,25,3
2020-12-09T11:08:56.558821,52.556045,13.365695, none, n,0.0045989808711185,34,59,65,10316,2906,594,39,3,2,1919,34,25,6
2020-12-09T11:08:57.575500,52.556005000000006,13.365704999999998, none, n,0.0049222699733357,35,62,68,10585,2940,616,37,3,3,1919,35,27,6
2020-12-09T11:08:58.591550,52.5559666667,13.365713333299999, none, n,0.0049222699733357,32,57,63,9826,2827,588,34,3,3,1919,32,25,6
2020-12-09T11:08:59.608109,52.555925,13.3657216667, none, n,0.0049222699733357,31,54,60,9336,2650,576,32,3,3,1919,31,23,6
2020-12-09T11:09:00.624214,52.5558883333,13.3657333333, none, n,0.0049222699733357,30,54,60,9288,2635,580,37,3,3,1919,30,24,6
2020-12-09T11:09:01.640222,52.5558483333,13.3657416667, none, n,0.0049222699733357,30,55,60,9228,2623,574,41,3,3,1919,30,25,5
2020-12-09T11:09:02.656668,52.55581,13.365751666700001, none, n,0.0049222699733357,29,54,59,8968,2579,556,43,3,3,1919,29,25,5
2020-12-09T11:09:03.672507,52.555769999999995,13.365763333299999, none, n,0.0049222699733357,29,54,59,9040,2585,556,41,3,2,1919,29,25,5
2020-12-09T11:09:04.689108,52.555728333299996,13.3657733333, none, n,0.0049222699733357,31,59,67,9820,2848,590,45,4,3,1919,31,28,8
2020-12-09T11:09:05.705419,52.5556883333,13.365785, none, n,0.0050892360570601,37,68,74,11066,3164,780,47,4,3,1919,37,31,6
2020-12-09T11:09:06.721498,52.555645,13.3657933333, none, n,0.0050892360570601,37,68,74,11066,3164,780,47,4,3,1919,37,31,6
2020-12-09T11:09:07.737367,52.5556066667,13.3658, none, n,0.0050892360570601,40,73,79,11631,3395,814,43,4,3,1919,40,33,6
2020-12-09T11:09:08.753340,52.555565,13.365808333299999, none, n,0.0050892360570601,40,73,79,11631,3395,814,43,4,3,1919,40,33,6
2020-12-09T11:09:09.768954,52.555530000000005,13.3658183333, none, n,0.0050892360570601,42,75,79,12372,3618,806,39,3,2,1919,42,33,4
2020-12-09T11:09:10.785529,52.5554916667,13.3658233333, none, n,0.0050892360570601,42,75,79,12372,3618,806,39,3,2,1919,42,33,4
2020-12-09T11:09:11.801095,52.5554533333,13.365829999999999, none, n,0.0050892360570601,46,81,86,13576,3924,838,42,3,2,1919,46,35,5
2020-12-09T11:09:12.817561,52.55542,13.3658383333, none, n,0.0050892360570601,48,85,90,14096,4121,864,46,3,2,1919,48,37,5
2020-12-09T11:09:13.834791,52.5553816667,13.365845000000002, none, n,0.0049057444861234,51,87,95,14613,4210,884,46,6,3,1919,51,36,8
2020-12-09T11:09:14.853304,52.555346666700004,13.365853333299999, none, n,0.0049057444861234,51,87,95,14631,4218,884,44,7,3,1919,51,36,8
2020-12-09T11:09:15.877579,52.5553066667,13.3658616667, none, n,0.0049057444861234,53,91,101,15226,4457,1044,44,8,4,1919,53,38,10
2020-12-09T11:09:16.901312,52.5552683333,13.3658666667, none, n,0.0049057444861234,55,90,101,15396,4472,1024,42,10,5,1919,55,35,11
2020-12-09T11:09:17.918066,52.55523,13.365875, none, n,0.0049057444861234,53,88,96,14969,4406,880,38,9,4,1919,53,35,8
2020-12-09T11:09:18.934884,52.5551883333,13.3658816667, none, n,0.0049057444861234,52,88,96,14909,4396,860,42,9,4,1919,52,36,8
2020-12-09T11:09:19.950944,52.555144999999996,13.3658883333, none, n,0.0049057444861234,57,91,101,15898,4664,876,46,9,3,1919,57,34,10
2020-12-09T11:09:20.967469,52.555103333299996,13.365895000000002, none, n,0.0049057444861234,63,99,110,16720,4968,1054,50,10,3,1919,63,36,11
2020-12-09T11:09:21.984720,52.5550616667,13.3659, none, n,0.005110874983077,64,101,113,16974,5130,1088,54,11,4,1919,64,37,12
2020-12-09T11:09:23.000641,52.5550216667,13.3659066667, none, n,0.005110874983077,71,108,121,18453,5499,1122,52,12,4,1919,71,37,13
2020-12-09T11:09:24.017671,52.5549833333,13.365915, none, n,0.005110874983077,73,115,125,19012,5730,1282,54,9,3,1919,73,42,10
2020-12-09T11:09:26.035906,52.5548633333,13.365936666700001, none, n,0.005110874983077,73,115,125,19012,5730,1282,54,9,3,1919,73,42,10
2020-12-09T11:09:27.052367,52.5548233333,13.365948333299999, none, n,0.005110874983077,81,125,264,20823,6255,1330,58,9,4,1919,81,44,139
2020-12-09T11:09:28.067344,52.5547833333,13.365960000000001, none, n,0.005110874983077,82,256,266,21083,6409,1342,66,8,3,1919,82,174,10
2020-12-09T11:09:29.089935,52.554741666700004,13.36597, none, n,0.0051279769098724,83,260,267,21540,6461,1374,68,6,2,1919,83,177,7
2020-12-09T11:09:30.106205,52.5546966667,13.365975, none, n,0.0051279769098724,86,265,272,22317,6720,1376,72,6,2,1919,86,179,7
2020-12-09T11:09:31.125828,52.554655000000004,13.365981666700002, none, n,0.0051279769098724,84,261,270,21842,6669,1382,68,7,2,1919,84,177,9
2020-12-09T11:09:32.148222,52.5546116667,13.365996666700001, none, n,0.0051279769098724,79,260,268,20999,6271,1393,74,9,3,1919,79,181,8
2020-12-09T11:09:33.165450,52.5545683333,13.3660083333, none, n,0.0051279769098724,72,126,262,19526,5913,1365,80,8,3,1919,72,54,136
2020-12-09T11:09:34.183072,52.5545283333,13.3660166667, none, n,0.0051279769098724,69,123,260,19024,5704,1333,80,10,3,1919,69,54,137
2020-12-09T11:09:35.201225,52.5544916667,13.3660233333, none, n,0.0051279769098724,64,115,124,17533,5223,1281,82,12,4,1919,64,51,9
2020-12-09T11:09:36.218329,52.554455000000004,13.366031666700001, none, n,0.0051279769098724,62,111,121,17198,5141,1133,80,12,4,1919,62,49,10
2020-12-09T11:09:37.237092,52.55441999999999,13.36604, none, n,0.0051542014687717,56,104,112,15665,4654,1099,78,11,3,1919,56,48,8
2020-12-09T11:09:38.251263,52.5543833333,13.36605, none, n,0.0051542014687717,54,99,108,15112,4453,1079,70,11,3,1919,54,45,9
2020-12-09T11:09:39.267978,52.5543483333,13.3660566667, none, n,0.0051542014687717,51,95,105,14413,4364,1045,72,10,3,1919,51,44,10
2020-12-09T11:09:40.296731,52.5543116667,13.3660616667, none, n,0.0051542014687717,51,95,105,14413,4364,1045,72,10,3,1919,51,44,10
2020-12-09T11:09:41.312619,52.554271666700004,13.366064999999999, none, n,0.0051542014687717,47,93,102,13872,4129,1053,70,10,3,1919,47,46,9
2020-12-09T11:09:42.328395,52.5542316667,13.366064999999999, none, n,0.0051542014687717,46,90,100,13388,3918,1039,72,10,4,1919,46,44,10
2020-12-09T11:09:43.345127,52.5541866667,13.366064999999999, none, n,0.0051542014687717,47,88,96,13331,3908,890,68,7,3,1919,47,41,8
2020-12-09T11:09:44.362799,52.554145,13.366064999999999, none, n,0.0051542014687717,47,86,94,13337,3898,878,66,8,4,1919,47,39,8
2020-12-09T11:09:45.378996,52.5541016667,13.3660683333, none, n,0.0050641280277906,47,86,92,13355,3906,874,64,5,3,1919,47,39,6
2020-12-09T11:09:46.396275,52.5540583333,13.3660716667, none, n,0.0050641280277906,46,86,90,13161,3874,888,62,3,2,1919,46,40,4
2020-12-09T11:09:47.417687,52.554015,13.366075, none, n,0.0050641280277906,44,83,89,12874,3701,874,66,4,2,1919,44,39,6
2020-12-09T11:09:48.426676,52.5539783333,13.366081666700001, none, n,0.0050641280277906,47,85,94,12844,3699,878,70,7,3,1919,47,38,9
2020-12-09T11:09:49.446326,52.5539433333,13.366085, none, n,0.0050641280277906,45,84,96,12668,3681,882,80,8,3,1919,45,39,12
2020-12-09T11:09:50.469484,52.55390500000001,13.366095000000001, none, n,0.0050641280277906,45,83,94,12668,3673,872,76,9,3,1919,45,38,11
2020-12-09T11:09:51.485267,52.5538633333,13.3661033333, none, n,0.0050641280277906,43,78,89,12079,3450,846,74,9,3,1919,43,35,11
2020-12-09T11:09:52.501316,52.553825,13.3661166667, none, n,0.0050641280277906,43,77,87,12052,3438,824,70,9,3,1919,43,34,10
2020-12-09T11:09:53.517889,52.5537866667,13.366128333299999, none, n,0.0050372337475783,40,71,82,11520,3347,784,64,10,3,1919,40,31,11
2020-12-09T11:09:54.535987,52.55375,13.366136666700001, none, n,0.0050372337475783,40,71,82,11520,3347,784,64,10,3,1919,40,31,11
2020-12-09T11:09:55.551228,52.5537116667,13.3661466667, none, n,0.0050372337475783,39,68,81,11266,3194,778,56,10,3,1919,39,29,13
2020-12-09T11:09:56.567047,52.5536766667,13.3661583333, none, n,0.0050372337475783,39,68,81,11266,3194,778,56,10,3,1919,39,29,13
2020-12-09T11:09:57.583946,52.5536433333,13.3661683333, none, n,0.0050372337475783,40,68,82,11314,3349,780,56,13,4,1919,40,28,14
2020-12-09T11:09:58.599367,52.553603333299996,13.366183333299999, none, n,0.0050372337475783,40,68,82,11314,3349,780,56,13,4,1919,40,28,14
2020-12-09T11:09:59.616244,52.553565,13.3661966667, none, n,0.0050372337475783,41,71,88,11565,3387,796,64,17,7,1919,41,30,17
2020-12-09T11:10:00.632965,52.55353,13.36621, none, n,0.0050372337475783,41,71,88,11565,3387,796,64,17,7,1919,41,30,17
2020-12-09T11:10:01.648475,52.5534966667,13.366228333299999, none, n,0.0047068013424918,39,66,84,11093,3192,778,60,17,8,1919,39,27,18
2020-12-09T11:10:02.664884,52.55346,13.366254999999999, none, n,0.0047068013424918,40,68,86,11526,3361,794,58,15,7,1919,40,28,18
2020-12-09T11:10:03.680556,52.5534266667,13.366278333299999, none, n,0.0047068013424918,41,72,88,11885,3418,814,56,15,7,1919,41,31,16
2020-12-09T11:10:04.697435,52.553394999999995,13.3662983333, none, n,0.0047068013424918,38,69,86,11111,3181,798,60,15,8,1919,38,31,17
2020-12-09T11:10:05.713691,52.5533666667,13.366320000000002, none, n,0.0047068013424918,39,71,88,11362,3356,808,60,16,9,1919,39,32,17
2020-12-09T11:10:06.729866,52.5533366667,13.3663366667, none, n,0.0047068013424918,39,75,92,11589,3391,838,68,15,8,1919,39,36,17
2020-12-09T11:10:07.746069,52.5533033333,13.3663533333, none, n,0.0047068013424918,39,75,92,11580,3393,834,70,15,9,1919,39,36,17
2020-12-09T11:10:08.766914,52.553265,13.366370000000002, none, n,0.0047068013424918,40,77,93,11804,3408,836,76,14,8,1919,40,37,16
2020-12-09T11:10:09.783514,52.5532333333,13.366385000000001, none, ne,0.0044483141219616,38,76,90,11383,3345,816,80,11,7,1919,38,38,14
2020-12-09T11:10:10.798898,52.5531983333,13.3664, none, ne,0.0044483141219616,38,77,92,11523,3351,818,82,11,9,1919,38,39,15
2020-12-09T11:10:11.815628,52.5531616667,13.366415, none, ne,0.0044483141219616,40,81,94,11873,3418,832,82,11,9,1919,40,41,13
2020-12-09T11:10:12.831626,52.5531133333,13.3664333333, none, ne,0.0044483141219616,39,78,90,11550,3369,808,78,10,9,1919,39,39,12
2020-12-09T11:10:13.848452,52.5530716667,13.366451666700002, none, ne,0.0044483141219616,39,76,87,11320,3350,790,74,10,10,1919,39,37,11
2020-12-09T11:10:14.866186,52.5530333333,13.366465, none, ne,0.0044483141219616,41,82,99,12073,3593,830,88,16,12,1919,41,41,17
2020-12-09T11:10:15.884391,52.5530016667,13.3664733333, none, ne,0.0044483141219616,40,81,97,11858,3426,830,86,16,11,1919,40,41,16
2020-12-09T11:10:16.902053,52.552965,13.366485, none, ne,0.0044483141219616,41,83,99,12076,3452,852,90,16,11,1919,41,42,16
2020-12-09T11:10:17.909196,52.55293,13.366504999999998, none, n,0.0049558608328058,41,86,104,12133,3603,880,94,18,11,1919,41,45,18
2020-12-09T11:10:18.917266,52.5528966667,13.366520000000001, none, n,0.0049558608328058,41,87,108,12309,3623,1024,98,21,12,1919,41,46,21
2020-12-09T11:10:19.925573,52.5528566667,13.3665366667, none, n,0.0049558608328058,43,88,112,12608,3680,1056,94,22,12,1919,43,45,24
2020-12-09T11:10:20.933145,52.552818333299996,13.366556666700001, none, n,0.0049558608328058,43,88,109,12656,3697,1048,92,20,7,1919,43,45,21
2020-12-09T11:10:21.953802,52.5527833333,13.366579999999999, none, n,0.0049558608328058,44,93,115,13167,3882,1082,102,22,6,1919,44,49,22
2020-12-09T11:10:22.976546,52.552751666700004,13.366596666700001, none, n,0.0049558608328058,46,96,122,13648,3961,1110,110,25,7,1919,46,50,26
2020-12-09T11:10:23.984637,52.5527233333,13.3666133333, none, n,0.0049558608328058,48,100,127,14371,4186,1126,112,27,7,1919,48,52,27
2020-12-09T11:10:24.996202,52.5526883333,13.366635, none, n,0.0049558608328058,53,104,126,14969,4425,1140,98,23,5,1919,53,51,22
2020-12-09T11:10:26.019128,52.5526533333,13.3666566667, none, ne,0.0046325535015483,54,106,257,15360,4476,1284,104,23,5,1919,54,52,151
2020-12-09T11:10:28.037306,52.55256,13.366696666700001, none, ne,0.0046325535015483,54,106,257,15432,4622,1142,100,23,5,1919,54,52,151
2020-12-09T11:10:29.058933,52.5525333333,13.3667083333, none, ne,0.0046325535015483,55,106,256,15704,4654,1150,100,23,4,1919,55,51,150
2020-12-09T11:10:30.076435,52.5524966667,13.3667283333, none, ne,0.0046325535015483,55,106,256,15704,4654,1150,100,23,4,1919,55,51,150
2020-12-09T11:10:31.094006,52.5524633333,13.366743333299999, none, ne,0.0046325535015483,55,103,122,15408,4609,1140,87,20,3,1919,55,48,19
2020-12-09T11:10:32.111137,52.5524333333,13.366755, none, ne,0.0046325535015483,58,106,123,15919,4694,1132,87,20,4,1919,58,48,17
2020-12-09T11:10:33.127941,52.5524,13.36677, none, ne,0.0041704326612736,60,107,122,16430,4890,1140,79,18,5,1919,60,47,15
2020-12-09T11:10:34.145429,52.552365,13.366791666700001, none, ne,0.0041704326612736,60,101,114,16134,4721,1098,67,15,5,1919,60,41,13
2020-12-09T11:10:35.162748,52.5523333333,13.3668133333, none, ne,0.0041704326612736,61,101,117,16427,4889,1104,63,17,5,1919,61,40,16
2020-12-09T11:10:36.182275,52.552305000000004,13.366826666700002, none, ne,0.0041704326612736,59,100,111,15928,4693,1106,57,14,4,1919,59,41,11
2020-12-09T11:10:37.200422,52.5522766667,13.36684, none, ne,0.0041704326612736,60,98,111,16170,4720,1094,53,14,4,1919,60,38,13
2020-12-09T11:10:38.218098,52.55224499999999,13.366855, none, ne,0.0041704326612736,59,96,110,15922,4677,1062,55,16,5,1919,59,37,14
2020-12-09T11:10:39.235588,52.5522116667,13.3668683333, none, ne,0.0041704326612736,58,93,107,15480,4627,1058,51,16,5,1919,58,35,14
2020-12-09T11:10:40.257140,52.552184999999994,13.366879999999998, none, ne,0.0041704326612736,58,92,105,15456,4615,1040,47,14,6,1919,58,34,13
2020-12-09T11:10:41.279049,52.55216,13.3668983333, none, ne,0.004008859050447,58,93,107,15656,4636,1046,50,15,7,1919,58,35,14
2020-12-09T11:10:42.295137,52.5521333333,13.3669183333, none, ne,0.004008859050447,55,90,107,14951,4404,1060,56,17,7,1919,55,35,17
2020-12-09T11:10:43.311283,52.552105000000005,13.366938333299998, none, ne,0.004008859050447,53,90,106,14392,4203,1046,64,16,6,1919,53,37,16
2020-12-09T11:10:44.328539,52.5520766667,13.366954999999999, none, ne,0.004008859050447,53,90,106,14392,4203,1046,64,16,6,1919,53,37,16
2020-12-09T11:10:45.345792,52.5520483333,13.366973333299999, none, ne,0.004008859050447,54,94,112,14888,4406,1084,68,19,9,1919,54,40,18
2020-12-09T11:10:46.361017,52.5520216667,13.3669933333, none, ne,0.004008859050447,54,94,112,14888,4406,1084,68,19,9,1919,54,40,18
2020-12-09T11:10:47.376628,52.55199,13.36701, none, ne,0.004008859050447,50,89,104,14156,4157,1044,62,14,8,1919,50,39,15
2020-12-09T11:10:48.393300,52.5519616667,13.367026666700001, none, ne,0.004008859050447,50,85,100,13857,4104,888,60,15,9,1919,50,35,15
2020-12-09T11:10:49.410583,52.5519316667,13.367045000000001, none, ne,0.0038939063194039,47,85,101,13152,3875,892,68,15,8,1919,47,38,16
2020-12-09T11:10:50.426970,52.5519,13.367066666700001, none, ne,0.0038939063194039,47,85,100,13113,3875,1038,66,12,7,1919,47,38,15
2020-12-09T11:10:51.443954,52.5518666667,13.3670883333, none, ne,0.0038939063194039,44,80,98,12572,3658,870,68,15,8,1919,44,36,18
2020-12-09T11:10:52.459664,52.551831666700004,13.3671083333, none, ne,0.0038939063194039,43,77,96,12091,3599,868,64,17,10,1919,43,34,19
2020-12-09T11:10:53.483721,52.5517983333,13.367125, none, ne,0.0038939063194039,43,77,96,12079,3601,860,66,16,9,1919,43,34,19
2020-12-09T11:10:54.489239,52.5517616667,13.36714, none, ne,0.0038939063194039,43,76,92,12055,3597,842,60,14,8,1919,43,33,16
2020-12-09T11:10:55.495958,52.5517183333,13.367154999999999, none, ne,0.0038939063194039,42,72,91,11846,3441,840,54,15,9,1919,42,30,19
2020-12-09T11:10:56.520883,52.551680000000005,13.367170000000002, none, ne,0.0038939063194039,43,71,86,11792,3449,822,47,12,6,1919,43,28,15
2020-12-09T11:10:57.539821,52.5516416667,13.367185000000001, none, ne,0.0048010136400006,46,76,91,12554,3704,878,47,12,6,1919,46,30,15
2020-12-09T11:10:58.560493,52.5516066667,13.3672, none, ne,0.0048010136400006,50,85,98,13400,4110,1036,53,11,5,1919,50,35,13
2020-12-09T11:10:59.578577,52.5515666667,13.3672216667, none, ne,0.0048010136400006,53,89,101,13941,4199,1064,51,9,6,1919,53,36,12
2020-12-09T11:11:00.600234,52.5515316667,13.3672433333, none, ne,0.0048010136400006,53,89,101,13941,4199,1064,51,9,6,1919,53,36,12
2020-12-09T11:11:01.617604,52.5514916667,13.3672666667, none, ne,0.0048010136400006,56,91,105,14879,4457,1068,47,10,7,1919,56,35,14
2020-12-09T11:11:02.636131,52.551455000000004,13.3672883333, none, ne,0.0048010136400006,62,101,111,16155,4917,1134,45,7,6,1919,62,39,10
2020-12-09T11:11:03.657309,52.55141999999999,13.36731, none, ne,0.0048010136400006,64,105,113,16765,5146,1140,45,5,3,1919,64,41,8
2020-12-09T11:11:04.678654,52.5513866667,13.3673366667, none, ne,0.0048010136400006,67,110,118,17246,5206,1148,55,6,3,1919,67,43,8
2020-12-09T11:11:05.695962,52.5513533333,13.367363333299998, none, ne,0.0048933372389166,66,111,118,17270,5217,1294,55,6,4,1919,66,45,7
2020-12-09T11:11:06.717258,52.55132,13.367386666700002, none, ne,0.0048933372389166,65,111,120,17246,5205,1294,59,8,3,1919,65,46,9
2020-12-09T11:11:07.733894,52.5512866667,13.367408333299998, none, ne,0.0048933372389166,61,109,118,16409,4924,1282,70,9,3,1919,61,48,9
2020-12-09T11:11:08.749529,52.5512533333,13.3674266667, none, ne,0.0048933372389166,58,102,115,15429,4657,1098,72,12,4,1919,58,44,13
2020-12-09T11:11:09.766393,52.551219999999994,13.367446666700001, none, ne,0.0048933372389166,53,96,109,14383,4353,1068,76,12,4,1919,53,43,13
2020-12-09T11:11:10.790236,52.551185,13.3674666667, none, ne,0.0048933372389166,48,88,99,13179,3921,888,66,11,3,1919,48,40,11
2020-12-09T11:11:11.809266,52.5511516667,13.367486666700001, none, ne,0.0048933372389166,43,85,95,12309,3645,868,72,10,2,1919,43,42,10
2020-12-09T11:11:12.823535,52.551115,13.367505, none, ne,0.0048933372389166,39,79,89,11526,3379,828,72,10,2,1919,39,40,10
2020-12-09T11:11:13.838975,52.5510766667,13.3675266667, none, ne,0.0046694310952969,37,76,86,10818,3150,808,74,9,2,1919,37,39,10
2020-12-09T11:11:14.858029,52.5510383333,13.367546666700001, none, ne,0.0046694310952969,37,76,86,10818,3150,808,74,9,2,1919,37,39,10
2020-12-09T11:11:15.879015,52.551005,13.367564999999999, none, ne,0.0046694310952969,34,70,82,10361,3084,798,64,11,2,1919,34,36,12
2020-12-09T11:11:16.896962,52.5509633333,13.367593333299999, none, ne,0.0046694310952969,34,70,82,10361,3084,798,64,11,2,1919,34,36,12
2020-12-09T11:11:17.916738,52.550925,13.3676183333, none, ne,0.0046694310952969,34,72,89,10573,3112,806,74,17,6,1919,34,38,17
2020-12-09T11:11:18.918926,52.5508866667,13.367643333299998, none, ne,0.0046694310952969,35,75,90,10848,3155,826,76,15,6,1919,35,40,15
2020-12-09T11:11:19.927345,52.550855000000006,13.3676666667, none, ne,0.0046694310952969,38,80,96,11589,3404,872,76,14,6,1919,38,42,16
2020-12-09T11:11:20.936072,52.5508266667,13.367686666700001, none, ne,0.0046694310952969,39,84,97,11858,3446,1032,80,12,5,1919,39,45,13
2020-12-09T11:11:21.958924,52.5507966667,13.3677066667, none, ne,0.0047755072102873,39,81,96,11840,3446,1024,72,13,6,1919,39,42,15
2020-12-09T11:11:22.979137,52.5507666667,13.367721666700001, none, ne,0.0047755072102873,39,81,97,11816,3450,890,74,14,6,1919,39,42,16
2020-12-09T11:11:23.999663,52.550740000000005,13.3677366667, none, ne,0.0047755072102873,38,76,95,11347,3379,874,72,17,6,1919,38,38,19
2020-12-09T11:11:25.017627,52.5507083333,13.36776, none, ne,0.0047755072102873,37,76,95,11078,3341,876,74,18,6,1919,37,39,19
2020-12-09T11:11:27.034164,52.5506083333,13.3678316667, none, ne,0.0047755072102873,36,76,96,10812,3177,866,76,19,6,1919,36,40,20
2020-12-09T11:11:28.038373,52.550575,13.367854999999999, none, ne,0.0047755072102873,37,74,92,10770,3173,848,71,16,6,1919,37,37,18
2020-12-09T11:11:29.060528,52.5505433333,13.367875, none, ne,0.0043402383769851,33,67,77,9730,2871,792,57,10,2,1919,33,34,10
2020-12-09T11:11:30.076787,52.550513333299996,13.3678983333, none, ne,0.0043402383769851,30,61,69,9037,2648,626,49,9,2,1919,30,31,8
2020-12-09T11:11:31.102031,52.5504866667,13.367921666700001, 3cobbleGroove2, ne,0.0043402383769851,29,57,66,8556,2573,576,47,12,5,1919,29,28,9
2020-12-09T11:11:32.118484,52.5504533333,13.3679466667, 3cobbleGroove2, ne,0.0043402383769851,28,53,63,8233,2385,552,41,11,5,1919,28,25,10
2020-12-09T11:11:33.136138,52.550419999999995,13.367973333299998, 3cobbleGroove2, ne,0.0043402383769851,27,53,62,7782,2326,550,43,11,4,1919,27,26,9
2020-12-09T11:11:34.153657,52.5503866667,13.367995, 3cobbleGroove2, ne,0.0043402383769851,27,53,62,7782,2326,550,43,11,4,1919,27,26,9
2020-12-09T11:11:35.169558,52.5503566667,13.36801, 3cobbleGroove2, ne,0.0043402383769851,28,53,62,8060,2372,554,41,10,4,1919,28,25,9
2020-12-09T11:11:36.186834,52.5503266667,13.3680283333, 3cobbleGroove2, ne,0.0043402383769851,31,59,64,8750,2603,610,37,7,4,1919,31,28,5
2020-12-09T11:11:37.206348,52.5502966667,13.368046666700002, 3cobbleGroove2, ne,0.0042547020428937,32,58,64,8995,2639,602,37,6,4,1919,32,26,6
2020-12-09T11:11:38.209166,52.5502683333,13.368063333299999, 3cobbleGroove2, ne,0.0042547020428937,33,58,64,9049,2659,608,33,5,4,1919,33,25,6
2020-12-09T11:11:39.231129,52.55024,13.3680783333, 3cobbleGroove2, ne,0.0042547020428937,32,58,67,8822,2616,622,40,8,5,1919,32,26,9
2020-12-09T11:11:40.254391,52.5502133333,13.3680883333, 3cobbleGroove2, ne,0.0042547020428937,36,66,73,9790,2881,794,40,7,4,1919,36,30,7
2020-12-09T11:11:41.272116,52.5501866667,13.368103333299999, 3cobbleGroove2, ne,0.0042547020428937,37,69,77,10561,3118,814,42,7,4,1919,37,32,8
2020-12-09T11:11:42.290242,52.5501633333,13.368115, 3cobbleGroove2, ne,0.0042547020428937,39,72,77,11036,3181,832,34,4,1,1919,39,33,5
2020-12-09T11:11:43.321011,52.55014,13.368125, 3cobbleGroove2, ne,0.0042547020428937,42,77,82,11867,3434,860,40,5,1,1919,42,35,5
2020-12-09T11:11:44.339674,52.5501183333,13.368135, 3cobbleGroove2, ne,0.0042547020428937,46,84,92,13071,3870,892,46,7,1,1919,46,38,8
2020-12-09T11:11:45.358633,52.5500966667,13.368151666700001, 3cobbleGroove2, ne,0.0033349742117186,48,87,93,13322,3903,1032,50,7,1,1919,48,39,6
2020-12-09T11:11:46.376087,52.5500816667,13.3681716667, 3cobbleGroove2, ne,0.0033349742117186,46,85,99,13382,3918,1026,64,12,6,1919,46,39,14
2020-12-09T11:11:47.403393,52.5500666667,13.368195000000002, 3cobbleGroove2, ne,0.0033349742117186,47,88,101,13884,4115,1054,60,13,6,1919,47,41,13
2020-12-09T11:11:48.416475,52.5500616667,13.3682216667, 3cobbleGroove2, ne,0.0033349742117186,47,88,101,13884,4115,1054,60,13,6,1919,47,41,13
2020-12-09T11:11:49.426978,52.55005500000001,13.368245000000002, 3cobbleGroove2, ne,0.0033349742117186,50,93,106,14649,4354,1086,62,13,6,1919,50,43,13
2020-12-09T11:11:50.435412,52.55005500000001,13.36827, 3cobbleGroove2, ne,0.0033349742117186,52,96,110,14649,4354,1086,62,13,6,1919,52,44,14
2020-12-09T11:11:51.444477,52.5500633333,13.3683016667, 3cobbleGroove2, ne,0.0033349742117186,57,101,113,15617,4630,1110,62,10,5,1919,57,44,12
2020-12-09T11:11:52.467019,52.5500716667,13.3683283333, 3cobbleGroove2, ne,0.0033349742117186,57,101,113,15617,4630,1110,62,10,5,1919,57,44,12
2020-12-09T11:11:53.489927,52.5500816667,13.36835, 3cobbleGroove2, e,0.0019305045667375,58,104,115,16248,4876,1128,64,10,5,1919,58,46,11
2020-12-09T11:11:54.513788,52.550095,13.368378333299999, 3cobbleGroove2, e,0.0019305045667375,58,104,115,16248,4876,1128,64,10,5,1919,58,46,11
2020-12-09T11:11:55.518672,52.5501066667,13.3684033333, 3cobbleGroove2, e,0.0019305045667375,62,108,119,16917,4973,1286,64,10,5,1919,62,46,11
2020-12-09T11:11:56.541464,52.5501216667,13.368435, 3cobbleGroove2, e,0.0019305045667375,62,108,119,16917,4973,1286,64,10,5,1919,62,46,11
2020-12-09T11:11:57.560977,52.5501366667,13.368471666700001, 3cobbleGroove2, e,0.0019305045667375,64,112,259,17530,5214,1318,78,19,6,1919,64,48,147
2020-12-09T11:11:58.576529,52.5501533333,13.3685133333, 3cobbleGroove2, e,0.0019305045667375,64,112,259,17530,5214,1318,78,19,6,1919,64,48,147
2020-12-09T11:11:59.598668,52.5501666667,13.3685516667, 3cobbleGroove2, e,0.0019305045667375,64,111,259,17482,5208,1320,76,21,7,1919,64,47,148
2020-12-09T11:12:00.606238,52.550180000000005,13.3685916667, 3cobbleGroove2, e,0.0019305045667375,64,109,259,17512,5200,1338,74,19,7,1919,64,45,150
2020-12-09T11:12:01.614808,52.550194999999995,13.36863, 3cobbleGroove2, e,0.0032489573212681,66,112,261,17942,5386,1330,76,20,7,1919,66,46,149
2020-12-09T11:12:02.641550,52.5502133333,13.368666666700001, 3cobbleGroove2, e,0.0032489573212681,68,114,257,18459,5458,1326,70,15,2,1919,68,46,143
2020-12-09T11:12:03.658633,52.5502266667,13.3687, 3cobbleGroove2, e,0.0032489573212681,70,118,264,18716,5490,1330,88,19,3,1919,70,48,146
2020-12-09T11:12:04.676876,52.5502416667,13.3687366667, 3cobbleGroove2, e,0.0032489573212681,72,118,269,19281,5713,1336,90,22,4,1919,72,46,151
2020-12-09T11:12:05.694525,52.5502566667,13.36878, 3cobbleGroove2, e,0.0032489573212681,71,116,265,19006,5670,1318,83,22,4,1919,71,45,149
2020-12-09T11:12:06.716493,52.55027,13.3688266667, 3cobbleGroove2, e,0.0032489573212681,67,111,261,18026,5394,1284,87,22,4,1919,67,44,150
2020-12-09T11:12:07.728639,52.550284999999995,13.368879999999999, 3cobbleGroove2, e,0.0032489573212681,63,106,256,17198,5132,1140,83,22,4,1919,63,43,150
2020-12-09T11:12:08.748973,52.5502983333,13.368929999999999, 3cobbleGroove2, e,0.0032489573212681,58,101,117,16209,4724,1114,73,13,3,1919,58,43,16
2020-12-09T11:12:09.786194,52.5503166667,13.3689833333, 3cobbleGroove2, e,0.0039221221219617,58,101,114,15901,4678,1108,75,11,2,1919,58,43,13
2020-12-09T11:12:10.789804,52.5503366667,13.369033333299999, 3cobbleGroove2, e,0.0039221221219617,56,98,112,15423,4611,1084,79,10,2,1919,56,42,14
2020-12-09T11:12:11.806080,52.5503533333,13.369081666700001, 3cobbleGroove2, e,0.0039221221219617,53,97,109,14927,4398,1098,77,9,2,1919,53,44,12
2020-12-09T11:12:12.829238,52.5503716667,13.369126666700001, 3cobbleGroove2, e,0.0039221221219617,53,97,109,14927,4398,1098,77,9,2,1919,53,44,12
2020-12-09T11:12:13.846602,52.550385,13.369175, 3cobbleGroove2, e,0.0039221221219617,51,92,104,14147,4155,1076,69,10,2,1919,51,41,12
2020-12-09T11:12:14.864291,52.550405000000005,13.369223333299999, 3cobbleGroove2, e,0.0039221221219617,51,92,104,14147,4155,1076,69,10,2,1919,51,41,12
2020-12-09T11:12:15.890863,52.550415,13.369275, 3cobbleGroove2, e,0.0039221221219617,48,88,98,13570,3947,1068,61,6,1,1919,48,40,10
2020-12-09T11:12:16.909680,52.550430000000006,13.369315, 3cobbleGroove2, e,0.0039221221219617,44,84,92,12381,3655,1050,59,4,1,1919,44,40,8
2020-12-09T11:12:17.913848,52.55044,13.3693566667, 3cobbleGroove2, e,0.0041039002780195,41,82,89,11780,3412,1032,64,5,2,1919,41,41,7
2020-12-09T11:12:18.921197,52.5504566667,13.3693883333, 3cobbleGroove2, e,0.0041039002780195,41,82,91,11628,3422,1036,60,6,2,1919,41,41,9
2020-12-09T11:12:19.929772,52.550468333299996,13.369425, 3cobbleGroove2, e,0.0041039002780195,41,81,89,11580,3408,888,64,7,2,1919,41,40,8
2020-12-09T11:12:20.938855,52.5504833333,13.369454999999999, 3cobbleGroove2, e,0.0041039002780195,42,81,91,11628,3430,878,62,8,3,1919,42,39,10
2020-12-09T11:12:21.961644,52.5505016667,13.3694866667, 3cobbleGroove2, e,0.0041039002780195,42,81,91,11792,3430,868,62,8,4,1919,42,39,10
2020-12-09T11:12:22.979252,52.5505166667,13.36953, 3cobbleGroove2, e,0.0041039002780195,42,81,90,11798,3439,872,56,8,4,1919,42,39,9
2020-12-09T11:12:24.018618,52.5505316667,13.3695783333, 1startpulse, e,0.0041039002780195,42,79,87,11377,3401,862,52,8,4,1919,42,37,8
2020-12-09T11:12:25.027636,52.5505416667,13.3696316667, 1startpulse, e,0.0031086706438568,42,80,87,11792,3442,862,54,7,4,1919,42,38,7
2020-12-09T11:12:27.050673,52.5505966667,13.3697783333, 1startpulse, e,0.0031086706438568,41,75,82,11547,3391,826,42,7,5,1919,41,34,7
2020-12-09T11:12:28.054442,52.5506116667,13.369833333299999, 1startpulse, e,0.0031086706438568,42,77,83,11819,3434,832,42,7,4,1919,42,35,6
2020-12-09T11:12:29.074763,52.550625,13.369886666700001, 1startpulse, e,0.0031086706438568,42,77,87,11795,3446,852,48,9,4,1919,42,35,10
2020-12-09T11:12:30.090072,52.550644999999996,13.369928333299999, 1startpulse, e,0.0031086706438568,42,77,86,11637,3434,838,46,8,4,1919,42,35,9
2020-12-09T11:12:31.111866,52.5506633333,13.369971666700001, 1startpulse, e,0.0031086706438568,42,75,85,11559,3408,834,44,10,5,1919,42,33,10
2020-12-09T11:12:32.129018,52.5506833333,13.370020000000002, 1startpulse, e,0.0031086706438568,42,75,85,11559,3408,834,44,10,5,1919,42,33,10
2020-12-09T11:12:33.149539,52.55070500000001,13.3700633333, 1startpulse, e,0.004910859663805,42,77,87,11625,3429,842,50,9,4,1919,42,35,10
2020-12-09T11:12:34.171380,52.550715000000004,13.370113333299999, 1startpulse, e,0.004910859663805,43,80,88,11837,3597,854,54,8,3,1919,43,37,8
2020-12-09T11:12:35.193431,52.5507266667,13.3701583333, 1startpulse, e,0.004910859663805,46,85,93,12414,3842,890,52,8,3,1919,46,39,8
2020-12-09T11:12:36.218601,52.550740000000005,13.370204999999999, 1startpulse, e,0.004910859663805,52,92,101,13636,4140,1046,58,8,3,1919,52,40,9
2020-12-09T11:12:37.239784,52.550755,13.3702466667, 1startpulse, e,0.004910859663805,52,93,102,13836,4162,1068,58,8,3,1919,52,41,9
2020-12-09T11:12:38.263085,52.5507633333,13.3702833333, 1startpulse, e,0.004910859663805,56,100,107,14458,4413,1114,60,7,2,1919,56,44,7
2020-12-09T11:12:39.285464,52.55076999999999,13.3703166667, 1startpulse, e,0.004910859663805,57,101,110,14855,4455,1124,62,9,2,1919,57,44,9
2020-12-09T11:12:40.307572,52.55078,13.370345, 1startpulse, e,0.004910859663805,60,106,114,15486,4682,1140,62,7,2,1919,60,46,8
2020-12-09T11:12:41.317727,52.5507916667,13.37036, 1startpulse, e,0.0031790526364847,61,110,117,15949,4869,1290,68,7,2,1919,61,49,7
2020-12-09T11:12:42.344387,52.550803333299996,13.370370000000001, 1startpulse, e,0.0031790526364847,64,117,124,16654,4968,1326,76,5,2,1919,64,53,7
2020-12-09T11:12:43.359354,52.5508133333,13.370375, 1startpulse, e,0.0031790526364847,62,115,120,16251,4917,1320,76,5,2,1919,62,53,5
2020-12-09T11:12:44.375173,52.5508233333,13.3703733333, 1startpulse, e,0.0031790526364847,62,114,119,16427,4913,1328,70,5,2,1919,62,52,5
2020-12-09T11:12:45.389898,52.55084,13.3703733333, 1startpulse, e,0.0031790526364847,59,109,120,15892,4676,1296,84,10,5,1919,59,50,11
2020-12-09T11:12:46.407931,52.5508583333,13.3703716667, 1startpulse, e,0.0031790526364847,59,109,120,15892,4676,1296,84,10,5,1919,59,50,11
2020-12-09T11:12:47.431772,52.5508733333,13.3703783333, 1startpulse, e,0.0031790526364847,55,104,117,14975,4434,1142,82,13,5,1919,55,49,13
2020-12-09T11:12:48.447577,52.5508883333,13.370385, 1startpulse, e,0.0031790526364847,55,104,120,14909,4422,1140,90,16,6,1919,55,49,16
2020-12-09T11:12:49.464659,52.550909999999995,13.370391666700002, 1startpulse, s,0.001904509455155,53,102,122,14894,4402,1118,100,21,7,1919,53,49,20
2020-12-09T11:12:50.481400,52.5509266667,13.370401666700001, 1startpulse, s,0.001904509455155,52,101,120,14413,4206,1108,102,19,8,1919,52,49,19
2020-12-09T11:12:51.498972,52.5509416667,13.3704166667, 1startpulse, s,0.001904509455155,50,98,119,13881,4127,1084,100,23,8,1919,50,48,21
2020-12-09T11:12:52.515885,52.550955,13.3704216667, 1startpulse, s,0.001904509455155,51,99,123,14147,4175,1094,106,24,9,1919,51,48,24
2020-12-09T11:12:53.536724,52.5509666667,13.3704216667, 1startpulse, s,0.001904509455155,51,99,120,14398,4203,1084,100,23,8,1919,51,48,21
2020-12-09T11:12:54.554171,52.550981666700004,13.3704166667, 1startpulse, s,0.001904509455155,50,98,120,14392,4203,1074,98,24,9,1919,50,48,22
2020-12-09T11:12:55.570705,52.5509983333,13.3704216667, 1startpulse, s,0.001904509455155,47,94,120,13869,4124,1056,102,27,10,1919,47,47,26
2020-12-09T11:12:56.587179,52.55101,13.3704283333, 1startpulse, s,0.001904509455155,47,93,113,13600,3953,1038,92,22,7,1919,47,46,20
2020-12-09T11:12:57.605242,52.5510233333,13.3704316667, 1startpulse, s,0.0018412633499174,47,91,109,13433,3941,1026,88,20,8,1919,47,44,18
2020-12-09T11:12:58.608022,52.551035,13.370441666700001, 1startpulse, s,0.0018412633499174,47,88,106,13355,3914,882,84,20,7,1919,47,41,18
2020-12-09T11:12:59.616792,52.55105,13.370458333299998, 1startpulse, s,0.0018412633499174,44,84,99,12390,3661,862,76,16,7,1919,44,40,15
2020-12-09T11:13:00.626850,52.5510633333,13.370479999999999, 1startpulse, s,0.0018412633499174,44,84,99,12390,3661,862,76,16,7,1919,44,40,15
2020-12-09T11:13:01.637248,52.551075,13.370493333299999, 1startpulse, s,0.0018412633499174,42,83,96,12121,3612,840,78,16,6,1919,42,41,13
2020-12-09T11:13:02.655663,52.5510933333,13.370510000000001, 1startpulse, s,0.0018412633499174,42,83,96,12121,3612,840,78,16,6,1919,42,41,13
2020-12-09T11:13:03.679066,52.5511133333,13.3705166667, 1startpulse, s,0.0018412633499174,42,84,99,12321,3647,852,80,14,8,1919,42,42,15
2020-12-09T11:13:04.696949,52.551134999999995,13.37052, 1startpulse, s,0.0018412633499174,42,84,99,12321,3647,852,80,14,8,1919,42,42,15
2020-12-09T11:13:05.714225,52.551155,13.370536666700001, 1startpulse, se,0.0023244019069922,44,80,94,12309,3637,834,68,13,7,1919,44,36,14
2020-12-09T11:13:06.731955,52.551175,13.3705583333, 1startpulse, se,0.0023244019069922,44,80,94,12309,3637,834,68,13,7,1919,44,36,14
2020-12-09T11:13:07.753557,52.55119499999999,13.3705766667, 1startpulse, se,0.0023244019069922,41,75,90,11553,3412,808,66,14,7,1919,41,34,15
2020-12-09T11:13:08.768358,52.5512216667,13.3706033333, 1startpulse, se,0.0023244019069922,44,80,95,12094,3623,842,76,13,6,1919,44,36,15
2020-12-09T11:13:09.783438,52.5512383333,13.3706183333, 1startpulse, se,0.0023244019069922,47,85,99,13062,3890,858,74,10,5,1919,47,38,14
2020-12-09T11:13:10.810936,52.5512533333,13.370629999999998, 1startpulse, se,0.0023244019069922,49,87,102,13349,3943,854,74,11,5,1919,49,38,15
2020-12-09T11:13:11.827825,52.551275,13.370645000000001, 1startpulse, se,0.0023244019069922,49,88,103,13143,3913,852,78,11,5,1919,49,39,15
2020-12-09T11:13:12.845779,52.551285,13.3706583333, 1startpulse, se,0.0023244019069922,50,93,105,13409,3960,872,84,8,5,1919,50,43,12
2020-12-09T11:13:13.863507,52.5513016667,13.370681666700001, 1startpulse, se,0.0027183640653068,52,95,109,14096,4181,888,86,8,5,1919,52,43,14
2020-12-09T11:13:14.898254,52.551316666700004,13.370705, none, se,0.0027183640653068,52,95,108,13944,4183,892,82,7,5,1919,52,43,13
2020-12-09T11:13:15.926714,52.5513466667,13.37076, none, se,0.0027183640653068,51,94,102,13663,4126,872,76,4,2,1919,51,43,8
2020-12-09T11:13:16.952415,52.5513783333,13.3708116667, none, se,0.0027183640653068,49,92,100,13355,3940,874,76,4,2,1919,49,43,8
2020-12-09T11:13:17.979229,52.5514133333,13.370865, none, se,0.0027183640653068,49,95,103,13349,3932,882,82,4,2,1919,49,46,8
2020-12-09T11:13:19.007534,52.551451666700004,13.370913333299999, none, se,0.0027183640653068,46,89,95,12632,3697,848,72,5,3,1919,46,43,6
2020-12-09T11:13:20.011896,52.5514883333,13.370958333299999, none, se,0.0027183640653068,42,85,93,12061,3607,846,72,6,4,1919,42,43,8
2020-12-09T11:13:22.035059,52.5515483333,13.371046666700002, none, se,0.0052708766702451,40,79,85,11290,3341,830,63,5,4,1919,40,39,6
2020-12-09T11:13:23.051429,52.5515666667,13.371061666700001, none, se,0.0052708766702451,40,81,90,11523,3383,848,73,7,4,1919,40,41,9
2020-12-09T11:13:24.055432,52.551586666700004,13.371075, none, se,0.0052708766702451,40,79,89,11299,3353,844,71,7,4,1919,40,39,10
2020-12-09T11:13:25.064190,52.551605,13.3710816667, none, se,0.0052708766702451,39,78,87,11123,3339,846,67,6,3,1919,39,39,9
2020-12-09T11:13:26.089581,52.5516233333,13.3710933333, none, se,0.0052708766702451,40,79,88,11568,3384,848,65,7,3,1919,40,39,9
2020-12-09T11:13:27.104905,52.55164499999999,13.3711166667, none, se,0.0052708766702451,40,78,87,11562,3376,844,63,7,3,1919,40,38,9
2020-12-09T11:13:28.131805,52.551678333299996,13.371163333299998, none, se,0.0052708766702451,39,78,91,11311,3337,840,73,10,4,1919,39,39,13
2020-12-09T11:13:29.148939,52.5517083333,13.3712166667, none, se,0.0052708766702451,39,75,88,11111,3191,822,67,10,5,1919,39,36,13
2020-12-09T11:13:30.165898,52.551735,13.3712666667, none, se,0.0036480009952189,40,80,93,11610,3398,844,73,9,4,1919,40,40,13
2020-12-09T11:13:31.182504,52.55175500000001,13.371310000000001, none, se,0.0036480009952189,40,81,93,11592,3404,832,77,11,4,1919,40,41,12
2020-12-09T11:13:32.199308,52.5517766667,13.371348333299999, none, se,0.0036480009952189,42,84,99,12133,3633,866,82,12,4,1919,42,42,15
2020-12-09T11:13:33.216742,52.5517966667,13.371376666700002, none, se,0.0036480009952189,41,83,98,12034,3587,858,78,16,4,1919,41,42,15
2020-12-09T11:13:34.234036,52.5518166667,13.3713966667, none, se,0.0036480009952189,44,83,101,12330,3641,874,72,17,5,1919,44,39,18
2020-12-09T11:13:35.250706,52.5518383333,13.3714083333, none, se,0.0036480009952189,44,83,103,12324,3641,866,78,18,6,1919,44,39,20
2020-12-09T11:13:36.267813,52.55186,13.37142, none, se,0.0036480009952189,42,80,101,11813,3446,864,78,17,6,1919,42,38,21
2020-12-09T11:13:37.285312,52.5518816667,13.371435, none, se,0.0036480009952189,41,83,104,11643,3446,876,84,18,7,1919,41,42,21
2020-12-09T11:13:38.301366,52.5519,13.3714466667, none, se,0.0031452576470888,46,88,107,12623,3858,886,80,16,6,1919,46,42,19
2020-12-09T11:13:39.318792,52.551921666700004,13.3714666667, none, se,0.0031452576470888,50,92,113,13633,4127,1054,80,16,5,1919,50,42,21
2020-12-09T11:13:40.336149,52.5519466667,13.371485, none, se,0.0031452576470888,50,92,113,13633,4127,1054,80,16,5,1919,50,42,21
2020-12-09T11:13:41.351503,52.551965,13.3715033333, none, se,0.0031452576470888,49,89,111,13397,4100,1040,76,17,6,1919,49,40,22
2020-12-09T11:13:42.367628,52.5519833333,13.371516666700002, none, se,0.0031452576470888,49,89,111,13397,4100,1040,76,17,6,1919,49,40,22
2020-12-09T11:13:43.383978,52.552,13.371529999999998, none, se,0.0031452576470888,50,89,108,13409,4100,1032,72,14,5,1919,50,39,19
2020-12-09T11:13:44.400440,52.5520233333,13.371554999999999, none, se,0.0031452576470888,50,89,108,13409,4100,1032,72,14,5,1919,50,39,19
2020-12-09T11:13:45.417004,52.552040000000005,13.371575, none, se,0.0031452576470888,50,91,108,13433,4121,1026,70,14,6,1919,50,41,17
2020-12-09T11:13:46.420279,52.552055,13.3715866667, none, se,0.0028090425898783,51,90,109,13660,4147,1038,70,12,6,1919,51,39,19
2020-12-09T11:13:47.441529,52.55206999999999,13.3715933333, none, se,0.0028090425898783,49,88,105,13182,3950,888,72,11,5,1919,49,39,17
2020-12-09T11:13:48.458554,52.5520916667,13.37161, none, se,0.0028090425898783,47,89,107,13152,3931,1026,70,11,4,1919,47,42,18
2020-12-09T11:13:49.475888,52.552103333299996,13.371616666700001, none, se,0.0028090425898783,49,92,109,13388,3955,1042,74,12,5,1919,49,43,17
2020-12-09T11:13:50.493237,52.552119999999995,13.3716416667, none, se,0.0028090425898783,49,90,106,13370,3949,1038,70,12,4,1919,49,41,16
2020-12-09T11:13:51.496931,52.5521383333,13.37168, none, se,0.0028090425898783,44,86,101,12575,3675,1036,68,11,4,1919,44,42,15
2020-12-09T11:13:52.517909,52.552165,13.3717333333, none, se,0.0028090425898783,41,82,97,11834,3446,882,70,10,4,1919,41,41,15
2020-12-09T11:13:53.525686,52.5521966667,13.3717916667, none, se,0.0028090425898783,41,78,93,11583,3400,866,64,10,4,1919,41,37,15
2020-12-09T11:13:54.538417,52.55224499999999,13.371868333299998, none, se,0.0040633176658907,39,76,91,11084,3199,860,62,11,5,1919,39,37,15
2020-12-09T11:13:55.550578,52.5522883333,13.371935, none, se,0.0040633176658907,39,75,89,11078,3184,868,60,10,4,1919,39,36,14
2020-12-09T11:13:56.572539,52.5523283333,13.371996666700001, none, se,0.0040633176658907,39,74,84,10845,3154,848,56,6,4,1919,39,35,10
2020-12-09T11:13:57.596711,52.55236,13.372046666700001, none, se,0.0040633176658907,36,72,80,10504,3090,828,50,6,4,1919,36,36,8
2020-12-09T11:13:58.613434,52.552385,13.372085, none, se,0.0040633176658907,36,72,80,10504,3090,828,50,6,4,1919,36,36,8
2020-12-09T11:13:59.630362,52.5524116667,13.3721183333, none, se,0.0040633176658907,38,74,84,10770,3143,848,56,6,5,1919,38,36,10
2020-12-09T11:14:00.635880,52.5524433333,13.372155, none, se,0.0040633176658907,39,73,84,10758,3151,844,56,6,4,1919,39,34,11
2020-12-09T11:14:01.651815,52.5524716667,13.3722016667, none, se,0.0040633176658907,39,77,88,11075,3187,860,58,8,4,1919,39,38,11
2020-12-09T11:14:02.668066,52.5525016667,13.372243333299998, none, se,0.0054536176653428,39,79,93,11305,3352,878,68,8,4,1919,39,40,14
2020-12-09T11:14:03.684445,52.5525316667,13.3722866667, none, se,0.0054536176653428,39,81,93,11305,3352,878,70,8,4,1919,39,42,12
2020-12-09T11:14:04.700573,52.5525566667,13.372320000000002, none, se,0.0054536176653428,40,86,97,11598,3407,1036,76,7,3,1919,40,46,11
2020-12-09T11:14:05.716617,52.5525783333,13.3723566667, none, se,0.0054536176653428,43,88,99,12085,3602,1068,76,6,2,1919,43,45,11
2020-12-09T11:14:06.733112,52.5525966667,13.3723916667, none, se,0.0054536176653428,43,90,104,12157,3621,1074,84,9,3,1919,43,47,14
2020-12-09T11:14:07.750101,52.552615,13.372421666700001, none, se,0.0054536176653428,44,94,106,12384,3663,1092,86,9,3,1919,44,50,12
2020-12-09T11:14:08.766008,52.552634999999995,13.3724466667, none, se,0.0054536176653428,47,96,111,13319,3916,1100,90,10,4,1919,47,49,15
2020-12-09T11:14:09.781803,52.5526566667,13.3724766667, none, se,0.0054536176653428,48,96,112,13325,3912,1098,90,12,6,1919,48,48,16
2020-12-09T11:14:10.797919,52.55268,13.372516666700001, none, se,0.0038722830101656,48,97,113,13430,3926,1100,94,14,6,1919,48,49,16
2020-12-09T11:14:11.814016,52.5527,13.3725483333, none, se,0.0038722830101656,50,98,116,13600,3949,1100,104,12,6,1919,50,48,18
2020-12-09T11:14:12.830326,52.5527216667,13.3725833333, none, se,0.0038722830101656,51,101,119,13600,3949,1100,104,12,6,1919,51,50,18
2020-12-09T11:14:13.847010,52.552744999999994,13.3726166667, none, se,0.0038722830101656,52,101,119,13830,4113,1100,100,13,7,1919,52,49,18
2020-12-09T11:14:14.863905,52.5527683333,13.372651666700001, none, se,0.0038722830101656,52,101,119,13830,4113,1100,100,13,7,1919,52,49,18
2020-12-09T11:14:15.880472,52.5527916667,13.3726866667, none, se,0.0038722830101656,53,101,117,14090,4152,1114,94,13,7,1919,53,48,16
2020-12-09T11:14:16.897101,52.5528116667,13.372720000000001, none, se,0.0038722830101656,53,101,120,13884,4143,1118,92,14,7,1919,53,48,19
2020-12-09T11:14:17.914580,52.55283000000001,13.37275, none, se,0.0038722830101656,51,100,117,13621,4108,1098,94,14,7,1919,51,49,17
2020-12-09T11:14:18.931843,52.5528516667,13.3727816667, none, se,0.0037399678201434,50,98,114,13439,3967,1088,90,11,6,1919,50,48,16
2020-12-09T11:14:19.947943,52.5528733333,13.372815, none, se,0.0037399678201434,49,95,110,13140,3907,1068,82,10,5,1919,49,46,15
2020-12-09T11:14:20.965143,52.55289499999999,13.372848333299999, none, se,0.0037399678201434,45,90,103,12363,3652,1052,78,10,4,1919,45,45,13
2020-12-09T11:14:21.982121,52.5529166667,13.372881666700001, none, se,0.0037399678201434,43,83,92,11592,3413,876,68,7,1,1919,43,40,9
2020-12-09T11:14:22.998537,52.5529416667,13.3729133333, none, se,0.0037399678201434,40,78,88,11027,3333,856,62,7,2,1919,40,38,10
2020-12-09T11:14:24.019420,52.5529633333,13.37294, none, se,0.0037399678201434,39,77,83,10588,3164,834,52,6,2,1919,39,38,6
2020-12-09T11:14:26.022470,52.553025,13.373038333299998, none, se,0.0037049845272116,36,72,80,10017,3073,798,48,8,1,1919,36,36,8
2020-12-09T11:14:27.044916,52.5530483333,13.373071666700001, none, se,0.0037049845272116,35,71,81,9841,2920,804,58,9,1,1919,35,36,10
2020-12-09T11:14:28.064142,52.5530716667,13.3731083333, none, se,0.0037049845272116,35,72,82,10017,2935,794,66,9,1,1919,35,37,10
2020-12-09T11:14:29.079437,52.5530966667,13.3731483333, none, se,0.0037049845272116,40,78,91,11051,3357,824,70,12,2,1919,40,38,13
2020-12-09T11:14:30.099073,52.5531216667,13.3731883333, none, se,0.0037049845272116,42,80,93,11269,3384,836,74,12,2,1919,42,38,13
2020-12-09T11:14:31.116009,52.553144999999994,13.373228333299998, none, se,0.0037049845272116,42,81,94,11287,3394,848,78,13,2,1919,42,39,13
2020-12-09T11:14:32.135871,52.5531683333,13.373263333299999, none, se,0.0037049845272116,43,82,100,11347,3420,856,92,15,3,1919,43,39,18
2020-12-09T11:14:33.152964,52.5531916667,13.3732983333, none, se,0.0037049845272116,43,82,101,11523,3434,854,94,16,3,1919,43,39,19
2020-12-09T11:14:34.173595,52.5532133333,13.3733266667, none, se,0.0040872385910068,44,85,104,11783,3610,864,96,16,3,1919,44,41,19
2020-12-09T11:14:35.196273,52.5532316667,13.373356666700001, none, se,0.0040872385910068,41,78,97,11126,3393,840,89,16,3,1919,41,37,19
2020-12-09T11:14:36.213384,52.5532533333,13.373385, none, se,0.0040872385910068,41,80,96,11266,3375,838,91,14,3,1919,41,39,16
2020-12-09T11:14:37.231684,52.553275,13.37341, none, se,0.0040872385910068,40,77,91,10615,3177,816,87,13,3,1919,40,37,14
2020-12-09T11:14:38.234497,52.553295,13.373439999999999, none, se,0.0040872385910068,39,72,85,10346,3122,794,73,13,3,1919,39,33,13
2020-12-09T11:14:39.242862,52.5533183333,13.3734716667, none, se,0.0040872385910068,34,66,77,9527,2844,630,73,10,2,1919,34,32,11
2020-12-09T11:14:40.264886,52.5533383333,13.373508333299998, none, se,0.0040872385910068,33,59,74,8998,2639,602,71,11,3,1919,33,26,15
2020-12-09T11:14:41.284621,52.5533583333,13.373535, none, se,0.0040872385910068,34,64,77,9515,2856,628,69,10,3,1919,34,30,13
2020-12-09T11:14:42.301608,52.553380000000004,13.3735666667, none, se,0.0035188579172551,34,63,73,9327,2838,630,57,8,3,1919,34,29,10
2020-12-09T11:14:43.317602,52.553394999999995,13.3735833333, none, se,0.0035188579172551,34,68,77,9557,2872,802,61,7,3,1919,34,34,9
2020-12-09T11:14:44.335480,52.5534083333,13.373593333299999, none, se,0.0035188579172551,35,71,80,10050,2933,812,59,7,3,1919,35,36,9
2020-12-09T11:14:45.352129,52.553421666700004,13.3736083333, none, se,0.0035188579172551,39,77,86,10818,3184,852,62,8,3,1919,39,38,9
2020-12-09T11:14:46.367524,52.5534366667,13.3736183333, none, se,0.0035188579172551,39,77,86,10818,3184,852,62,8,3,1919,39,38,9
2020-12-09T11:14:47.384889,52.5534466667,13.3736233333, none, se,0.0035188579172551,43,82,91,11535,3425,884,62,7,3,1919,43,39,9
2020-12-09T11:14:48.400277,52.5534566667,13.373629999999999, none, se,0.0035188579172551,45,86,95,12300,3662,1040,62,7,3,1919,45,41,9
2020-12-09T11:14:49.416890,52.553465,13.373635, none, se,0.0035188579172551,45,86,95,12118,3646,1044,61,6,3,1919,45,41,9
2020-12-09T11:14:50.433207,52.55347,13.373641666700001, none, se,0.0016027496719213,45,89,99,12348,3675,1062,63,9,6,1919,45,44,10
2020-12-09T11:14:51.449689,52.5534833333,13.3736516667, none, se,0.0016027496719213,47,93,103,12659,3845,1094,61,9,6,1919,47,46,10
2020-12-09T11:14:52.466093,52.5535,13.3736666667, none, se,0.0016027496719213,44,91,102,12142,3628,1064,71,9,6,1919,44,47,11
2020-12-09T11:14:53.482610,52.553513333299996,13.373681666700001, none, se,0.0016027496719213,47,95,104,12823,3843,1088,73,8,5,1919,47,48,9
2020-12-09T11:14:54.501602,52.553535,13.373693333299999, none, se,0.0016027496719213,47,93,105,12859,3847,1068,77,11,6,1919,47,46,12
2020-12-09T11:14:55.517137,52.5535483333,13.3736966667, none, se,0.0016027496719213,45,90,100,12402,3658,1050,77,8,5,1919,45,45,10
2020-12-09T11:14:56.539872,52.553556666700004,13.373705, none, se,0.0016027496719213,45,89,100,12578,3661,1044,79,8,6,1919,45,44,11
2020-12-09T11:14:57.560838,52.5535766667,13.3737233333, none, se,0.0016027496719213,43,86,99,12294,3613,1032,79,11,7,1919,43,43,13
2020-12-09T11:14:58.581022,52.553594999999994,13.373745000000001, none, se,0.0022223783472542,42,84,99,11801,3420,888,81,14,7,1919,42,42,15
2020-12-09T11:14:59.598542,52.5536083333,13.3737633333, none, se,0.0022223783472542,40,84,99,11619,3402,888,84,14,7,1919,40,44,15
2020-12-09T11:15:00.617896,52.553630000000005,13.373783333299999, none, se,0.0022223783472542,38,77,89,11024,3165,850,74,11,4,1919,38,39,12
2020-12-09T11:15:01.639304,52.553644999999996,13.3738033333, none, se,0.0022223783472542,36,75,85,10615,3135,818,74,10,3,1919,36,39,10
2020-12-09T11:15:02.655593,52.553675,13.373861666700002, none, se,0.0022223783472542,36,75,85,10615,3135,818,74,10,3,1919,36,39,10
2020-12-09T11:15:03.672435,52.5537116667,13.373945, none, se,0.0022223783472542,34,67,78,10032,2904,782,61,10,3,1919,34,33,11
2020-12-09T11:15:04.689685,52.5537416667,13.374025, none, se,0.0022223783472542,30,60,70,8992,2614,606,55,10,3,1919,30,30,10
2020-12-09T11:15:05.706082,52.553765000000006,13.374101666700001, none, se,0.0022223783472542,29,56,62,8478,2405,576,47,7,2,1919,29,27,6
2020-12-09T11:15:06.722321,52.5537883333,13.374179999999999, none, se,0.0052041694713593,26,54,62,8200,2359,568,47,10,3,1919,26,28,8
2020-12-09T11:15:07.739598,52.5537966667,13.374245000000002, none, se,0.0052041694713593,29,58,71,8735,2577,610,55,14,2,1919,29,29,13
2020-12-09T11:15:08.759484,52.553803333299996,13.3743066667, none, se,0.0052041694713593,29,58,70,8723,2574,606,49,14,1,1919,29,29,12
2020-12-09T11:15:09.777875,52.5538083333,13.3743683333, none, se,0.0052041694713593,31,61,72,9222,2645,622,49,14,2,1919,31,30,11
2020-12-09T11:15:10.794693,52.5538116667,13.374429999999998, none, se,0.0052041694713593,37,67,79,10029,2918,634,55,14,2,1919,37,30,12
2020-12-09T11:15:11.812394,52.55381,13.3744983333, none, se,0.0052041694713593,40,76,88,11051,3349,816,63,14,2,1919,40,36,12
2020-12-09T11:15:12.828612,52.5538166667,13.3745633333, none, se,0.0052041694713593,45,81,95,11897,3616,844,65,15,2,1919,45,36,14
2020-12-09T11:15:13.847439,52.5538233333,13.374626666700001, none, se,0.0052041694713593,56,97,111,14425,4386,1056,68,15,2,1919,56,41,14
2020-12-09T11:15:14.870529,52.5538333333,13.374695000000001, none, e,0.0050251511617442,65,108,122,16248,4931,1120,72,16,2,1919,65,43,14
2020-12-09T11:15:15.887352,52.5538333333,13.374758333299999, none, e,0.0050251511617442,68,114,259,17201,5195,1290,78,19,3,1919,68,46,145
2020-12-09T11:15:16.904255,52.5538316667,13.374820000000001, none, e,0.0050251511617442,73,120,265,17960,5448,1316,78,19,3,1919,73,47,145
2020-12-09T11:15:17.921477,52.5538233333,13.3748733333, none, e,0.0050251511617442,68,115,257,17180,5179,1286,72,15,4,1919,68,47,142
2020-12-09T11:15:18.938906,52.5538083333,13.3749233333, none, e,0.0050251511617442,68,115,257,17180,5179,1286,72,15,4,1919,68,47,142
2020-12-09T11:15:19.956154,52.553801666700004,13.374979999999999, none, e,0.0050251511617442,66,114,126,16941,5149,1288,76,12,4,1919,66,48,12
2020-12-09T11:15:20.975173,52.55379,13.375029999999999, none, e,0.0050251511617442,66,114,126,16941,5149,1288,76,12,4,1919,66,48,12
2020-12-09T11:15:21.992696,52.55379,13.37509, none, e,0.0050251511617442,62,108,120,16212,4902,1126,74,10,3,1919,62,46,12
2020-12-09T11:15:23.010192,52.553794999999994,13.375145000000002, none, e,0.0043887030861099,58,100,112,15193,4608,1102,65,10,3,1919,58,42,12
2020-12-09T11:15:24.031177,52.5537883333,13.375195000000001, none, e,0.0043887030861099,52,89,100,13830,4114,1026,55,10,3,1919,52,37,11
2020-12-09T11:15:26.048253,52.55379,13.3753516667, none, e,0.0043887030861099,47,80,90,12620,3671,858,49,9,3,1919,47,33,10
2020-12-09T11:15:27.065434,52.55379,13.3754016667, none, e,0.0043887030861099,38,67,77,10522,3087,786,49,9,3,1919,38,29,10
2020-12-09T11:15:28.082701,52.55379,13.3754533333, none, e,0.0043887030861099,32,61,70,9222,2625,612,45,8,3,1919,32,29,9
2020-12-09T11:15:29.100535,52.55379,13.375508333299999, none, e,0.0043887030861099,28,55,62,8305,2370,588,41,5,2,1919,28,27,7
2020-12-09T11:15:30.121096,52.5537883333,13.375565, none, e,0.0040578820293728,25,51,57,7976,2163,568,37,3,1,1919,25,26,6
2020-12-09T11:15:31.124885,52.5537916667,13.375613333299999, none, e,0.0040578820293728,28,51,57,7952,2173,554,37,5,0,1919,28,23,6
2020-12-09T11:15:32.146868,52.553794999999994,13.375661666700001, none, e,0.0040578820293728,28,50,59,7976,2313,556,39,6,1,1919,28,22,9
2020-12-09T11:15:33.163584,52.55379,13.375706666700001, none, e,0.0040578820293728,30,53,62,8299,2373,578,39,5,1,1919,30,23,9
2020-12-09T11:15:34.180771,52.553785,13.375751666700001, none, e,0.0040578820293728,32,56,65,8795,2570,590,42,6,2,1919,32,24,9
2020-12-09T11:15:35.197288,52.553775,13.375796666700001, none, e,0.0040578820293728,34,60,70,9336,2655,620,44,6,2,1919,34,26,10
2020-12-09T11:15:36.214727,52.5537633333,13.375841666700001, none, e,0.0040578820293728,34,60,70,9336,2655,620,44,6,2,1919,34,26,10
2020-12-09T11:15:37.231967,52.55375,13.375886666700001, none, e,0.0040578820293728,35,62,74,9748,2837,632,44,7,3,1919,35,27,12
2020-12-09T11:15:38.249023,52.5537466667,13.375938333299999, none, e,0.0036660320690625,35,62,74,9748,2837,632,44,7,3,1919,35,27,12
2020-12-09T11:15:39.265813,52.5537483333,13.375993333299999, none, e,0.0036660320690625,38,66,80,10564,3089,790,44,10,6,1919,38,28,14
2020-12-09T11:15:40.290783,52.5537466667,13.3760466667, none, e,0.0036660320690625,38,66,80,10564,3089,790,44,10,6,1919,38,28,14
2020-12-09T11:15:41.306677,52.55375,13.3761066667, none, e,0.0036660320690625,39,69,84,10812,3123,806,48,13,7,1919,39,30,15
2020-12-09T11:15:42.325027,52.5537533333,13.3761633333, none, e,0.0036660320690625,39,69,84,10812,3123,806,48,13,7,1919,39,30,15
2020-12-09T11:15:43.339759,52.553756666700004,13.376220000000002, none, e,0.0036660320690625,43,72,92,11601,3376,832,46,18,8,1919,43,29,20
2020-12-09T11:15:44.357162,52.5537633333,13.376275, none, e,0.0036660320690625,43,72,92,11601,3376,832,46,18,8,1919,43,29,20
2020-12-09T11:15:45.373519,52.55376999999999,13.376335000000001, none, e,0.0036660320690625,44,74,92,11876,3429,836,44,17,8,1919,44,30,18
2020-12-09T11:15:46.390671,52.55378,13.376395, none, e,0.0044423144862039,44,74,92,11876,3429,836,44,17,8,1919,44,30,18
2020-12-09T11:15:47.406707,52.5537866667,13.37645, none, e,0.0044423144862039,46,76,92,12327,3616,842,40,14,8,1919,46,30,16
2020-12-09T11:15:48.428353,52.5537933333,13.376501666700001, none, e,0.0044423144862039,46,76,92,12327,3616,842,40,14,8,1919,46,30,16
2020-12-09T11:15:49.448606,52.55379,13.37655, none, e,0.0044423144862039,44,74,90,12303,3596,830,36,16,8,1919,44,30,16
2020-12-09T11:15:50.468426,52.55378,13.376596666700001, none, e,0.0044423144862039,43,74,89,12094,3450,814,36,16,8,1919,43,31,15
2020-12-09T11:15:51.484906,52.5537633333,13.37664, none, e,0.0044423144862039,42,73,88,11640,3390,814,44,16,7,1919,42,31,15
2020-12-09T11:15:52.500553,52.5537516667,13.376698333299998, none, e,0.0044423144862039,44,79,95,12309,3615,836,54,16,7,1919,44,35,16
2020-12-09T11:15:53.516494,52.5537366667,13.376743333299999, none, e,0.0044423144862039,44,80,95,12321,3621,834,58,15,6,1919,44,36,15
2020-12-09T11:15:54.534870,52.5537216667,13.37679, none, e,0.0039259657322537,43,82,93,12085,3592,844,60,13,3,1919,43,39,11
2020-12-09T11:15:55.554219,52.5537083333,13.376836666700001, none, e,0.0039259657322537,43,78,88,12043,3440,806,56,11,2,1919,43,35,10
2020-12-09T11:15:56.566453,52.5536983333,13.376881666700001, none, e,0.0039259657322537,42,75,86,11538,3361,786,64,11,1,1919,42,33,11
2020-12-09T11:15:57.585024,52.5536866667,13.376926666700001, none, e,0.0039259657322537,39,72,82,10764,3105,630,66,12,2,1919,39,33,10
2020-12-09T11:15:58.599301,52.5536766667,13.376973333299999, none, e,0.0039259657322537,37,68,78,10259,2896,606,66,12,2,1919,37,31,10
2020-12-09T11:15:59.618404,52.553665,13.377018333299999, none, e,0.0039259657322537,37,69,79,10253,2900,610,72,14,1,1919,37,32,10
2020-12-09T11:16:00.634558,52.553655000000006,13.377065, none, e,0.0039259657322537,35,65,78,9751,2833,596,68,15,2,1919,35,30,13
2020-12-09T11:16:01.650821,52.5536416667,13.377113333299999, none, e,0.0039259657322537,35,62,73,9557,2816,572,57,14,2,1919,35,27,11
2020-12-09T11:16:02.667395,52.5536283333,13.377161666700001, none, e,0.0038838083226806,35,62,73,9557,2816,572,57,14,2,1919,35,27,11
2020-12-09T11:16:03.684205,52.5536133333,13.377211666700001, none, e,0.0038838083226806,32,52,64,8738,2414,518,44,14,2,1919,32,20,12
2020-12-09T11:16:04.699002,52.5535983333,13.377263333299998, none, e,0.0038838083226806,32,52,64,8738,2414,518,44,14,2,1919,32,20,12
2020-12-09T11:16:05.718617,52.553585,13.3773133333, none, e,0.0038838083226806,30,48,60,8230,2337,370,44,14,2,1919,30,18,12
2020-12-09T11:16:06.738946,52.55356999999999,13.377358333299998, none, e,0.0038838083226806,30,48,60,8230,2337,370,44,14,2,1919,30,18,12
2020-12-09T11:16:07.759411,52.55355,13.3774016667, none, e,0.0038838083226806,26,42,53,7516,2110,320,40,14,2,1919,26,16,11
2020-12-09T11:16:08.779423,52.55353,13.377441666700001, none, e,0.0038838083226806,27,42,54,7516,2110,320,40,14,2,1919,27,15,12
2020-12-09T11:16:09.796803,52.5535083333,13.377479999999998, none, e,0.0038838083226806,27,47,59,7540,2126,360,48,16,2,1919,27,20,12
2020-12-09T11:16:10.820516,52.5534916667,13.3775166667, none, e,0.004058221969953,27,47,59,7534,2136,362,46,12,3,1919,27,20,12
2020-12-09T11:16:11.837494,52.553475,13.3775566667, none, e,0.004058221969953,29,55,69,8224,2367,534,60,16,7,1919,29,26,14
2020-12-09T11:16:12.854344,52.55345500000001,13.3775933333, none, e,0.004058221969953,32,59,74,8735,2572,572,57,16,7,1919,32,27,15
2020-12-09T11:16:13.871990,52.5534333333,13.377625, none, e,0.004058221969953,32,61,73,8992,2608,584,49,11,7,1919,32,29,12
2020-12-09T11:16:14.887383,52.5534183333,13.3776566667, none, e,0.004058221969953,34,68,79,9835,2870,624,57,10,6,1919,34,34,11
2020-12-09T11:16:15.904040,52.5534,13.3776883333, none, e,0.004058221969953,38,74,87,10812,3144,788,64,11,6,1919,38,36,13
2020-12-09T11:16:16.918373,52.5533816667,13.377718333299999, none, e,0.004058221969953,41,81,97,11541,3394,836,73,14,9,1919,41,40,16
2020-12-09T11:16:17.940386,52.5533616667,13.3777416667, none, e,0.004058221969953,45,87,104,12366,3660,870,75,14,9,1919,45,42,17
2020-12-09T11:16:18.957552,52.5533433333,13.3777583333, none, ne,0.0033166684233720003,49,95,112,13406,3942,1052,75,13,9,1919,49,46,17
2020-12-09T11:16:19.975064,52.5533233333,13.377765, none, ne,0.0033166684233720003,51,99,113,13941,4167,1070,67,10,9,1919,51,48,14
2020-12-09T11:16:20.991910,52.5533,13.377761666700001, none, ne,0.0033166684233720003,55,100,114,14694,4390,1096,61,12,9,1919,55,45,14
2020-12-09T11:16:22.009381,52.553275,13.3777466667, none, ne,0.0033166684233720003,54,99,113,14649,4378,1098,57,10,7,1919,54,45,14
2020-12-09T11:16:23.025858,52.55325,13.377718333299999, none, ne,0.0033166684233720003,54,99,113,14649,4378,1098,57,10,7,1919,54,45,14
2020-12-09T11:16:26.043341,52.553185,13.3776, none, nw,0.0029435566701574,52,93,109,14132,4169,1066,60,13,7,1919,52,41,16
2020-12-09T11:16:28.060044,52.5531083333,13.3774966667, none, nw,0.0029435566701574,54,93,111,14380,4352,1064,60,16,8,1919,54,39,18
2020-12-09T11:16:29.078135,52.553088333299996,13.3774666667, none, nw,0.0029435566701574,52,91,109,13881,4147,1046,58,17,8,1919,52,39,18
2020-12-09T11:16:30.095345,52.5530666667,13.3774283333, none, nw,0.0029435566701574,47,82,99,12569,3681,876,52,16,8,1919,47,35,17
2020-12-09T11:16:31.112265,52.553045,13.377393333299999, none, nw,0.0029435566701574,46,78,93,12094,3606,850,48,16,6,1919,46,32,15
2020-12-09T11:16:32.138842,52.5530266667,13.3773616667, none, nw,0.0029435566701574,42,70,87,11096,3188,820,46,17,7,1919,42,28,17
2020-12-09T11:16:33.156171,52.55301,13.3773283333, none, nw,0.0029435566701574,41,69,87,10782,3141,810,54,18,8,1919,41,28,18
2020-12-09T11:16:34.172803,52.5529916667,13.3772883333, none, nw,0.0043003463772324,38,67,86,10247,2922,788,62,19,8,1919,38,29,19
2020-12-09T11:16:35.189705,52.552975,13.377251666700001, none, nw,0.0043003463772324,36,67,83,9575,2855,772,68,17,7,1919,36,31,16
2020-12-09T11:16:36.206521,52.55296,13.3772183333, none, nw,0.0043003463772324,36,65,80,9739,2869,638,60,14,4,1919,36,29,15
2020-12-09T11:16:37.223245,52.5529483333,13.3771883333, none, nw,0.0043003463772324,38,72,86,10280,3084,790,68,12,5,1919,38,34,14
2020-12-09T11:16:38.239783,52.5529283333,13.377153333299999, none, nw,0.0043003463772324,37,73,83,10074,2918,794,70,9,4,1919,37,36,10
2020-12-09T11:16:39.256769,52.5529033333,13.377111666700001, none, nw,0.0043003463772324,40,76,86,10615,3131,808,66,8,4,1919,40,36,10
2020-12-09T11:16:40.273514,52.5528816667,13.377073333299998, none, nw,0.0043003463772324,40,76,86,10615,3131,808,66,8,4,1919,40,36,10
2020-12-09T11:16:41.290498,52.552859999999995,13.3770366667, none, nw,0.0043003463772324,48,87,99,12638,3692,876,66,9,4,1919,48,39,12
2020-12-09T11:16:42.306709,52.5528366667,13.3770016667, none, nw,0.0037051831007206,50,93,104,13367,3929,1056,68,9,3,1919,50,43,11
2020-12-09T11:16:43.323460,52.552815,13.376970000000002, none, nw,0.0037051831007206,57,106,117,14966,4446,1126,76,11,3,1919,57,49,11
2020-12-09T11:16:44.339977,52.55279,13.376935000000001, none, nw,0.0037051831007206,60,110,122,15641,4665,1138,74,13,5,1919,60,50,12
2020-12-09T11:16:45.355915,52.5527683333,13.3769016667, none, nw,0.0037051831007206,64,111,127,16421,4904,1296,70,17,6,1919,64,47,16
2020-12-09T11:16:46.371937,52.55275,13.3768683333, none, nw,0.0037051831007206,65,114,256,16959,5127,1326,62,16,6,1919,65,49,142
2020-12-09T11:16:47.388947,52.5527333333,13.376838333299998, none, nw,0.0037051831007206,69,119,263,17975,5409,1344,64,16,6,1919,69,50,144
2020-12-09T11:16:48.404749,52.552715,13.3768033333, none, nw,0.0037051831007206,72,122,267,18456,5488,1358,70,18,6,1919,72,50,145
2020-12-09T11:16:49.421778,52.55269499999999,13.376771666700002, none, nw,0.0037051831007206,72,123,268,18534,5644,1356,70,18,6,1919,72,51,145
2020-12-09T11:16:50.437661,52.552675,13.376738333299999, none, nw,0.0036144178329158,70,123,273,18492,5498,1368,80,23,7,1919,70,53,150
2020-12-09T11:16:51.454267,52.552655,13.376705, none, nw,0.0036144178329158,69,122,273,18432,5476,1364,82,23,7,1919,69,53,151
2020-12-09T11:16:52.470263,52.552634999999995,13.376675, none, nw,0.0036144178329158,70,123,272,18468,5488,1346,86,20,7,1919,70,53,149
2020-12-09T11:16:53.486378,52.552616666700004,13.376643333299999, none, nw,0.0036144178329158,65,115,263,17461,5204,1296,76,18,7,1919,65,50,148
2020-12-09T11:16:54.503604,52.5525966667,13.3766116667, none, nw,0.0036144178329158,63,113,259,16938,4983,1150,78,18,5,1919,63,50,146
2020-12-09T11:16:55.519398,52.5525766667,13.376579999999999, none, nw,0.0036144178329158,61,114,259,16699,4969,1280,82,14,4,1919,61,53,145
2020-12-09T11:16:56.535656,52.5525566667,13.376548333299999, none, nw,0.0036144178329158,60,110,259,16173,4866,1118,94,17,5,1919,60,50,149
2020-12-09T11:16:57.551915,52.5525366667,13.3765116667, none, nw,0.0036144178329158,57,106,127,15432,4629,1100,94,17,5,1919,57,49,21
2020-12-09T11:16:58.568705,52.5525133333,13.3764733333, none, nw,0.0036257736092233,57,106,127,15432,4629,1100,94,17,5,1919,57,49,21
2020-12-09T11:16:59.585252,52.55249,13.376435, none, nw,0.0036257736092233,55,104,122,14715,4399,1088,92,15,4,1919,55,49,18
2020-12-09T11:17:00.601007,52.5524683333,13.3763983333, none, nw,0.0036257736092233,55,104,122,14715,4399,1088,92,15,4,1919,55,49,18
2020-12-09T11:17:01.617309,52.5524483333,13.376363333299999, none, nw,0.0036257736092233,55,104,122,14897,4429,1102,87,15,4,1919,55,49,18
2020-12-09T11:17:02.634292,52.55243000000001,13.37633, none, nw,0.0036257736092233,55,104,122,14897,4429,1102,87,15,4,1919,55,49,18
2020-12-09T11:17:03.650590,52.5524116667,13.376295, none, nw,0.0036257736092233,59,106,120,15402,4648,1102,83,11,3,1919,59,47,14
2020-12-09T11:17:04.667558,52.552391666700004,13.376261666700001, none, nw,0.0036257736092233,56,106,119,14873,4447,1100,89,11,3,1919,56,50,13
2020-12-09T11:17:05.684459,52.552369999999996,13.376225, none, nw,0.0036257736092233,55,104,118,14443,4397,1094,85,12,4,1919,55,49,14
2020-12-09T11:17:06.700598,52.552346666700004,13.3761866667, none, nw,0.0038308792865639,55,109,127,14879,4458,1126,97,16,8,1919,55,54,18
2020-12-09T11:17:07.716522,52.5523266667,13.3761516667, none, nw,0.0038308792865639,57,110,127,15181,4635,1136,97,13,7,1919,57,53,17
2020-12-09T11:17:08.733794,52.552303333299996,13.376116666700002, none, nw,0.0038308792865639,59,114,261,15698,4712,1287,101,17,8,1919,59,55,147
2020-12-09T11:17:09.750399,52.5522816667,13.376083333299999, none, nw,0.0038308792865639,60,115,259,15958,4887,1301,89,14,7,1919,60,55,144
2020-12-09T11:17:10.766043,52.5522616667,13.376045000000001, none, nw,0.0038308792865639,57,117,261,15874,4726,1327,91,17,7,1919,57,60,144
2020-12-09T11:17:11.782181,52.5522416667,13.3760066667, none, nw,0.0038308792865639,59,117,263,15976,4897,1337,87,17,8,1919,59,58,146
2020-12-09T11:17:12.798502,52.5522216667,13.3759716667, none, nw,0.0038308792865639,59,117,263,15958,4879,1333,88,17,8,1919,59,58,146
2020-12-09T11:17:13.814831,52.5522016667,13.375938333299999, none, nw,0.0038308792865639,58,117,262,15659,4702,1343,90,16,8,1919,58,59,145
2020-12-09T11:17:14.831489,52.55218000000001,13.3759066667, none, nw,0.0037846031129644,59,115,263,15719,4714,1337,92,18,8,1919,59,56,148
2020-12-09T11:17:15.847681,52.552155000000006,13.375879999999999, none, nw,0.0037846031129644,60,118,265,15967,4886,1353,96,18,8,1919,60,58,147
2020-12-09T11:17:16.864704,52.5521316667,13.375865, none, nw,0.0037846031129644,60,118,265,15967,4886,1353,96,18,8,1919,60,58,147
2020-12-09T11:17:17.881371,52.552103333299996,13.375855, none, nw,0.0037846031129644,61,119,263,16406,4950,1369,88,14,3,1919,61,58,144
2020-12-09T11:17:18.897667,52.5520816667,13.3758566667, none, nw,0.0037846031129644,61,119,263,16406,4950,1369,88,14,3,1919,61,58,144
2020-12-09T11:17:19.915312,52.5520516667,13.375846666700001, none, nw,0.0037846031129644,60,119,263,16200,4940,1365,90,15,3,1919,60,59,144
2020-12-09T11:17:21.931762,52.55195,13.375786666700002, none, nw,0.0037846031129644,60,119,263,16200,4940,1365,90,15,3,1919,60,59,144
2020-12-09T11:17:22.948491,52.5519083333,13.375758333299999, none, nw,0.0045470349064799,56,110,123,15393,4669,1324,80,11,3,1919,56,54,13
2020-12-09T11:17:23.966036,52.551875,13.3757266667, none, nw,0.0045470349064799,56,110,123,15393,4669,1324,80,11,3,1919,56,54,13
2020-12-09T11:17:24.982804,52.5518583333,13.375695, none, nw,0.0045470349064799,55,108,119,14900,4468,1304,78,11,3,1919,55,53,11
2020-12-09T11:17:25.998715,52.5518466667,13.375668333299998, none, nw,0.0045470349064799,55,104,113,14667,4444,1126,72,8,3,1919,55,49,9
2020-12-09T11:17:27.016941,52.5518283333,13.375639999999999, none, nw,0.0045470349064799,52,96,105,14096,4201,1074,64,8,3,1919,52,44,9
2020-12-09T11:17:28.037378,52.5518066667,13.375604999999998, none, nw,0.0045470349064799,50,93,108,13439,4118,1056,76,11,4,1919,50,43,15
2020-12-09T11:17:29.054362,52.551788333299996,13.375570000000002, none, nw,0.0045470349064799,47,85,100,12626,3861,868,68,14,5,1919,47,38,15
2020-12-09T11:17:30.083541,52.5517716667,13.3755366667, none, nw,0.0030491098737636,45,80,92,12091,3640,840,58,11,5,1919,45,35,12
2020-12-09T11:17:31.099425,52.5517533333,13.3754983333, none, nw,0.0030491098737636,43,73,89,11586,3427,798,52,13,7,1919,43,30,16
2020-12-09T11:17:32.115237,52.5517333333,13.37546, none, nw,0.0030491098737636,40,68,81,10752,3148,612,48,12,7,1919,40,28,13
2020-12-09T11:17:33.131185,52.5517116667,13.375420000000002, none, nw,0.0030491098737636,38,65,80,10259,3073,600,50,12,8,1919,38,27,15
2020-12-09T11:17:34.149241,52.5516916667,13.375379999999998, none, nw,0.0030491098737636,37,63,80,9844,2900,576,54,14,10,1919,37,26,17
2020-12-09T11:17:35.166193,52.5516716667,13.37534, none, nw,0.0030491098737636,38,65,85,10271,3073,586,62,17,11,1919,38,27,20
2020-12-09T11:17:36.189948,52.5516533333,13.375304999999999, none, nw,0.0030491098737636,38,68,91,10295,3075,616,76,18,11,1919,38,30,23
2020-12-09T11:17:37.208176,52.55163,13.37527, none, nw,0.0030491098737636,42,75,97,11523,3387,788,74,17,10,1919,42,33,22
2020-12-09T11:17:38.232578,52.5516033333,13.375235, none, nw,0.0039547202468623,42,75,97,11523,3387,788,74,17,10,1919,42,33,22
2020-12-09T11:17:39.236283,52.55158,13.375195000000001, none, nw,0.0039547202468623,43,78,96,11810,3436,798,68,15,10,1919,43,35,18
2020-12-09T11:17:40.244147,52.5515616667,13.3751583333, none, nw,0.0039547202468623,43,78,96,11810,3436,798,68,15,10,1919,43,35,18
2020-12-09T11:17:41.252387,52.55154,13.3751216667, none, nw,0.0039547202468623,45,82,97,12145,3610,814,70,12,9,1919,45,37,15
2020-12-09T11:17:42.271524,52.5515183333,13.375085, none, nw,0.0039547202468623,46,85,101,12554,3667,824,74,13,10,1919,46,39,16
2020-12-09T11:17:43.297163,52.55149,13.375045000000002, none, nw,0.0039547202468623,46,85,99,12641,3681,828,70,10,7,1919,46,39,14
2020-12-09T11:17:44.320470,52.551455000000004,13.375, none, nw,0.0039547202468623,46,86,101,12599,3679,836,78,11,8,1919,46,40,15
2020-12-09T11:17:45.341502,52.5514283333,13.37496, none, nw,0.0039547202468623,47,86,100,12826,3705,848,70,11,7,1919,47,39,14
2020-12-09T11:17:46.366693,52.5514,13.374920000000001, none, nw,0.0044372809586598,49,87,99,12901,3865,858,66,9,4,1919,49,38,12
2020-12-09T11:17:47.388112,52.5513733333,13.3748816667, none, nw,0.0044372809586598,46,86,96,12590,3684,860,66,7,3,1919,46,40,10
2020-12-09T11:17:48.411578,52.551345,13.374845, none, nw,0.0044372809586598,46,85,95,12572,3678,858,62,6,3,1919,46,39,10
2020-12-09T11:17:49.416968,52.551318333299996,13.374808333299999, none, nw,0.0044372809586598,43,80,90,11538,3392,846,62,6,3,1919,43,37,10
2020-12-09T11:17:51.425246,52.5512383333,13.3747016667, none, nw,0.0044372809586598,42,81,91,11362,3365,848,66,6,3,1919,42,39,10
2020-12-09T11:17:52.453145,52.5512116667,13.374670000000002, none, nw,0.0044372809586598,43,81,94,11532,3384,856,66,7,4,1919,43,38,13
2020-12-09T11:17:53.468384,52.551185,13.3746383333, none, nw,0.0044372809586598,42,83,93,11302,3355,856,68,6,3,1919,42,41,10
2020-12-09T11:17:54.491851,52.5511583333,13.3746066667, none, nw,0.0048884106743316,41,81,92,10869,3181,850,70,6,3,1919,41,40,11
2020-12-09T11:17:55.511254,52.5511316667,13.374575, none, nw,0.0048884106743316,42,85,95,11380,3388,880,70,8,3,1919,42,43,10
2020-12-09T11:17:56.535595,52.55110500000001,13.374545000000001, none, nw,0.0048884106743316,42,84,94,11329,3374,870,68,8,3,1919,42,42,10
2020-12-09T11:17:57.552467,52.5510766667,13.3745166667, none, nw,0.0048884106743316,41,82,94,11341,3368,862,68,8,4,1919,41,41,12
2020-12-09T11:17:58.569699,52.55105,13.374486666700001, none, nw,0.0048884106743316,42,84,94,11574,3388,852,66,8,4,1919,42,42,10
2020-12-09T11:17:59.586882,52.5510216667,13.3744583333, none, nw,0.0048884106743316,42,84,94,11574,3388,852,66,8,4,1919,42,42,10
2020-12-09T11:18:00.604208,52.55099499999999,13.374431666700001, none, nw,0.0048884106743316,41,82,93,11586,3388,832,64,8,4,1919,41,41,11
2020-12-09T11:18:01.623143,52.5509683333,13.3744083333, none, nw,0.0048884106743316,41,82,93,11586,3388,832,64,8,4,1919,41,41,11
2020-12-09T11:18:02.626050,52.5509433333,13.374381666700002, none, nw,0.0040481022091645,41,81,94,11526,3372,828,66,11,5,1919,41,40,13
2020-12-09T11:18:03.634039,52.55092,13.374355, none, nw,0.0040481022091645,41,81,96,11556,3381,824,68,13,5,1919,41,40,15
2020-12-09T11:18:04.643366,52.550895,13.374329999999999, none, nw,0.0040481022091645,41,81,99,11804,3421,844,68,17,7,1919,41,40,18
2020-12-09T11:18:05.653453,52.5508683333,13.374303333299999, none, nw,0.0040481022091645,41,80,101,11858,3427,838,72,20,8,1919,41,39,21
2020-12-09T11:18:06.673735,52.55084,13.3742783333, none, nw,0.0040481022091645,41,78,102,11828,3423,838,72,21,8,1919,41,37,24
2020-12-09T11:18:07.688658,52.5508133333,13.374256666700001, none, nw,0.0040481022091645,42,78,99,12100,3453,830,68,18,7,1919,42,36,21
2020-12-09T11:18:08.712013,52.5507866667,13.3742383333, none, nw,0.0040481022091645,40,76,95,11786,3393,806,66,17,7,1919,40,36,19
2020-12-09T11:18:09.716799,52.5507633333,13.374220000000001, none, nw,0.0040481022091645,45,85,103,12871,3701,850,70,16,6,1919,45,40,18
2020-12-09T11:18:10.724907,52.5507416667,13.374201666700001, none, nw,0.0036448736034063,51,91,112,14177,4177,1024,76,16,6,1919,51,40,21
2020-12-09T11:18:11.745888,52.5507216667,13.3741833333, none, nw,0.0036448736034063,55,95,116,14897,4414,1060,70,16,6,1919,55,40,21
2020-12-09T11:18:12.759843,52.5507033333,13.3741666667, none, nw,0.0036448736034063,55,98,117,15115,4446,1064,74,14,5,1919,55,43,19
2020-12-09T11:18:13.794974,52.5506866667,13.374151666700001, none, nw,0.0036448736034063,58,99,115,15187,4612,1068,68,12,4,1919,58,41,16
2020-12-09T11:18:14.798561,52.55067,13.3741383333, none, nw,0.0036448736034063,59,102,115,15620,4654,1074,66,8,2,1919,59,43,13
2020-12-09T11:18:15.806907,52.5506566667,13.3741233333, none, nw,0.0036448736034063,59,106,119,15656,4673,1092,72,10,4,1919,59,47,13
2020-12-09T11:18:16.828103,52.550644999999996,13.374106666700001, none, nw,0.0036448736034063,60,108,124,16131,4725,1114,76,12,5,1919,60,48,16
2020-12-09T11:18:17.845121,52.550635,13.3740866667, none, nw,0.0036448736034063,59,105,125,15444,4650,1102,80,19,8,1919,59,46,20
2020-12-09T11:18:18.864069,52.5506266667,13.374065, none, nw,0.0022538132501489,63,111,266,16251,4915,1142,94,24,11,1919,63,48,155
2020-12-09T11:18:19.880683,52.5506216667,13.374039999999999, none, nw,0.0022538132501489,56,103,259,15145,4469,1104,98,25,11,1919,56,47,156
2020-12-09T11:18:20.898526,52.5506216667,13.374018333299999, none, nw,0.0022538132501489,51,97,124,13824,4125,1050,96,25,12,1919,51,46,27
2020-12-09T11:18:21.920500,52.5506233333,13.3740033333, none, nw,0.0022538132501489,49,90,121,12874,3866,894,98,28,13,1919,49,41,31
2020-12-09T11:18:22.936654,52.5506283333,13.3739883333, none, nw,0.0022538132501489,45,86,117,12303,3631,866,98,28,14,1919,45,41,31
2020-12-09T11:18:23.954351,52.5506333333,13.373973333299999, none, nw,0.0022538132501489,40,78,108,11287,3339,822,96,27,14,1919,40,38,30
2020-12-09T11:18:24.971044,52.5506383333,13.37396, none, nw,0.0022538132501489,36,68,98,9993,2895,768,91,26,13,1919,36,32,30
2020-12-09T11:18:25.988887,52.55064,13.3739483333, none, nw,0.0022538132501489,36,68,95,9829,2883,638,81,26,10,1919,36,32,27
2020-12-09T11:18:27.005858,52.5506433333,13.3739383333, none, w,0.0012518418757738,37,69,95,9993,2916,774,81,24,10,1919,37,32,26
2020-12-09T11:18:28.033802,52.550644999999996,13.37393, none, w,0.0012518418757738,37,69,90,10017,2918,776,73,17,7,1919,37,32,21
2020-12-09T11:18:29.044836,52.5506433333,13.37393, none, w,0.0012518418757738,34,65,81,9476,2827,628,61,12,4,1919,34,31,16
2020-12-09T11:18:30.059848,52.5506416667,13.37393, none, w,0.0012518418757738,34,64,77,9264,2681,616,51,11,4,1919,34,30,13
2020-12-09T11:18:31.075651,52.5506416667,13.37393, none, w,0.0012518418757738,33,63,73,8986,2645,620,45,10,3,1919,33,30,10
2020-12-09T11:18:32.091098,52.5506416667,13.37393, none, w,0.0012518418757738,33,63,73,8986,2645,620,45,10,3,1919,33,30,10
2020-12-09T11:18:33.110340,52.5506416667,13.37393, none, w,0.0012518418757738,33,63,71,9082,2675,610,39,8,3,1919,33,30,8
2020-12-09T11:18:34.122481,52.5506416667,13.37393, none, w,8.469582082500699e-05,33,63,71,9082,2675,610,39,8,3,1919,33,30,8
2020-12-09T11:18:35.134371,52.5506416667,13.37393, none, w,8.469582082500699e-05,36,65,72,9757,2890,622,33,7,2,1919,36,29,7
2020-12-09T11:18:36.142119,52.5506416667,13.37393, none, w,8.469582082500699e-05,36,65,72,9757,2890,622,33,7,2,1919,36,29,7
2020-12-09T11:18:37.163107,52.5506416667,13.37393, none, w,8.469582082500699e-05,37,67,73,9802,2906,632,33,7,2,1919,37,30,6
2020-12-09T11:18:38.180002,52.5506416667,13.37393, none, w,8.469582082500699e-05,37,67,73,9802,2906,632,33,7,2,1919,37,30,6
2020-12-09T11:18:39.195947,52.5506416667,13.37393, none, w,8.469582082500699e-05,38,72,81,10349,3121,792,42,10,3,1919,38,34,9
2020-12-09T11:18:40.213633,52.5506416667,13.37393, none, w,8.469582082500699e-05,38,70,76,10301,3088,782,36,5,3,1919,38,32,6
2020-12-09T11:18:41.233820,52.5506416667,13.37393, none, w,8.469582082500699e-05,37,70,80,10259,2931,780,46,9,5,1919,37,33,10
2020-12-09T11:18:42.250439,52.5506416667,13.37393, none, n,0.0,36,73,86,10041,2905,798,58,14,8,1919,36,37,13
2020-12-09T11:18:43.266673,52.5506416667,13.37393, none, n,0.0,36,72,87,10089,2909,794,58,14,8,1919,36,36,15
2020-12-09T11:18:44.284385,52.5506416667,13.37393, none, n,0.0,37,78,94,10588,3100,822,72,17,11,1919,37,41,16
2020-12-09T11:18:45.300941,52.5506366667,13.3739316667, none, n,0.0,40,80,97,11087,3169,840,72,17,11,1919,40,40,17
2020-12-09T11:18:46.317183,52.550635,13.373923333299999, none, n,0.0,40,84,101,11326,3187,860,80,17,11,1919,40,44,17
2020-12-09T11:18:47.338870,52.5506333333,13.3739016667, none, n,0.0,41,88,107,11837,3388,894,86,18,11,1919,41,47,19
2020-12-09T11:18:48.355210,52.550630000000005,13.373875, none, n,0.0,46,93,112,12838,3670,1060,82,18,11,1919,46,47,19
2020-12-09T11:18:49.371411,52.550625,13.3738466667, none, n,0.0,46,93,112,12862,3688,1062,80,18,11,1919,46,47,19
2020-12-09T11:18:50.387455,52.5506183333,13.373814999999999, none, w,0.0011709908503905,49,101,120,13585,3937,1098,90,19,12,1919,49,52,19
2020-12-09T11:18:51.403098,52.550615,13.373775, none, w,0.0011709908503905,50,102,120,13887,4116,1096,90,17,9,1919,50,52,18
2020-12-09T11:18:52.419079,52.55061,13.373743333299998, none, w,0.0011709908503905,53,106,120,14610,4215,1106,86,13,7,1919,53,53,14
2020-12-09T11:18:54.435729,52.5506,13.37365, none, w,0.0011709908503905,55,111,124,14897,4398,1126,90,13,7,1919,55,56,13
2020-12-09T11:18:55.451763,52.550594999999994,13.37362, none, w,0.0011709908503905,55,111,124,14897,4398,1126,90,13,7,1919,55,56,13
2020-12-09T11:18:56.469130,52.5505833333,13.373596666700001, none, w,0.0011709908503905,55,106,118,14855,4390,1100,75,10,4,1919,55,51,12
2020-12-09T11:18:57.494495,52.5505683333,13.3735733333, none, w,0.0011709908503905,56,106,117,15169,4436,1116,73,11,5,1919,56,50,11
2020-12-09T11:18:58.511268,52.5505516667,13.3735566667, none, w,0.0027107073545751,56,106,117,15193,4445,1134,69,11,5,1919,56,50,11
2020-12-09T11:18:59.533591,52.5505316667,13.373545000000002, none, w,0.0027107073545751,53,102,113,14616,4362,1108,71,11,6,1919,53,49,11
2020-12-09T11:19:00.547750,52.5505033333,13.373538333299999, none, w,0.0027107073545751,52,103,116,14422,4208,1100,87,12,6,1919,52,51,13
2020-12-09T11:19:01.568191,52.550475,13.373525, none, w,0.0027107073545751,53,106,116,14398,4198,1084,85,10,5,1919,53,53,10
2020-12-09T11:19:02.585065,52.5504483333,13.3735166667, none, w,0.0027107073545751,52,102,115,13929,4138,1066,85,14,5,1919,52,50,13
2020-12-09T11:19:03.602001,52.5504183333,13.3735066667, none, w,0.0027107073545751,52,98,108,13645,4097,1052,71,11,5,1919,52,46,10
2020-12-09T11:19:04.618720,52.5503883333,13.373493333299999, none, w,0.0027107073545751,49,92,103,13349,3921,1028,65,11,5,1919,49,43,11
2020-12-09T11:19:05.635768,52.5503616667,13.3734733333, none, w,0.0027107073545751,50,89,105,13385,3939,1032,65,14,8,1919,50,39,16
2020-12-09T11:19:06.659989,52.5503283333,13.373458333299999, none, nw,0.0036725737040078,50,92,108,13573,3961,1050,72,15,8,1919,50,42,16
2020-12-09T11:19:07.676866,52.5502966667,13.3734366667, none, nw,0.0036725737040078,50,93,108,13403,3951,1044,78,14,7,1919,50,43,15
2020-12-09T11:19:08.696241,52.5502633333,13.3734166667, none, nw,0.0036725737040078,50,95,111,13403,3955,1044,86,14,7,1919,50,45,16
2020-12-09T11:19:09.713146,52.5502366667,13.3733916667, none, nw,0.0036725737040078,50,95,111,13403,3955,1044,86,14,7,1919,50,45,16
2020-12-09T11:19:10.739573,52.5502083333,13.3733783333, none, nw,0.0036725737040078,51,98,115,13878,4150,1066,88,16,6,1919,51,47,17
2020-12-09T11:19:11.761249,52.5501816667,13.373365, none, nw,0.0036725737040078,51,98,115,13878,4150,1066,88,16,6,1919,51,47,17
2020-12-09T11:19:12.800779,52.550155000000004,13.373346666700002, 2christianWall, nw,0.0036725737040078,51,94,109,13636,4121,1058,72,16,7,1919,51,43,15
2020-12-09T11:19:13.824289,52.550125,13.373325, 2christianWall, nw,0.0036725737040078,50,95,111,13642,4119,1072,72,16,8,1919,50,45,16
2020-12-09T11:19:14.858786,52.550095,13.373295, 2christianWall, nw,0.0040282658754173,49,94,107,13331,3930,1072,72,11,7,1919,49,45,13
2020-12-09T11:19:15.874222,52.5500683333,13.373271666700001, 2christianWall, nw,0.0040282658754173,47,94,106,13062,3888,1076,74,11,7,1919,47,47,12
2020-12-09T11:19:16.890040,52.550041666700004,13.373251666700002, 2christianWall, nw,0.0040282658754173,49,98,111,13358,3940,1092,80,13,7,1919,49,49,13
2020-12-09T11:19:17.905403,52.550015,13.3732316667, 2christianWall, nw,0.0040282658754173,47,99,108,12877,3875,1076,80,10,4,1919,47,52,9
2020-12-09T11:19:18.934042,52.54999,13.3732083333, 2christianWall, nw,0.0040282658754173,45,97,106,12336,3662,1066,80,10,4,1919,45,52,9
2020-12-09T11:19:19.951118,52.5499716667,13.373173333299999, 2christianWall, nw,0.0040282658754173,42,93,107,11795,3587,1056,86,17,5,1919,42,51,14
2020-12-09T11:19:20.970916,52.54995,13.3731466667, 2christianWall, nw,0.0040282658754173,42,93,107,11777,3587,1042,92,17,5,1919,42,51,14
2020-12-09T11:19:21.992181,52.549925,13.373121666700001, 2christianWall, nw,0.0040282658754173,41,92,107,11589,3438,1046,94,15,5,1919,41,51,15
2020-12-09T11:19:23.031493,52.5498983333,13.3730966667, 2christianWall, nw,0.0036646520739838,42,93,110,11643,3445,1052,102,15,5,1919,42,51,17
2020-12-09T11:19:24.036274,52.5498766667,13.373071666700001, 2christianWall, nw,0.0036646520739838,42,94,111,11631,3445,1062,106,14,4,1919,42,52,17
2020-12-09T11:19:25.048722,52.549859999999995,13.3730416667, 2christianWall, nw,0.0036646520739838,44,93,111,11870,3605,1032,102,17,5,1919,44,49,18
2020-12-09T11:19:26.072308,52.5498433333,13.37301, 2christianWall, nw,0.0036646520739838,44,93,111,11870,3605,1032,102,17,5,1919,44,49,18
2020-12-09T11:19:27.096094,52.54983000000001,13.372971666700002, 2christianWall, nw,0.0036646520739838,45,97,118,12303,3664,1052,112,17,5,1919,45,52,21
2020-12-09T11:19:28.114499,52.5498333333,13.372928333299999, 2christianWall, nw,0.0036646520739838,44,94,112,11903,3614,1044,108,15,5,1919,44,50,18
2020-12-09T11:19:29.119238,52.5498466667,13.372881666700001, 2christianWall, nw,0.0036646520739838,44,93,111,11903,3606,1040,106,15,5,1919,44,49,18
2020-12-09T11:19:30.135886,52.5498566667,13.372831666700002, 2christianWall, w,0.0026438957852482,44,94,115,12330,3642,1040,110,17,5,1919,44,50,21
2020-12-09T11:19:31.145719,52.5498666667,13.372779999999999, 2christianWall, w,0.0026438957852482,44,94,114,12324,3646,1028,112,13,5,1919,44,50,20
2020-12-09T11:19:32.171386,52.5498766667,13.3727283333, 2christianWall, w,0.0026438957852482,44,93,115,12300,3642,1036,106,17,7,1919,44,49,22
2020-12-09T11:19:33.189892,52.5498866667,13.372679999999999, 2christianWall, w,0.0026438957852482,45,96,117,12614,3691,1046,104,17,7,1919,45,51,21
2020-12-09T11:19:34.206803,52.5498983333,13.3726333333, 2christianWall, w,0.0026438957852482,43,92,118,12333,3652,1046,104,23,9,1919,43,49,26
2020-12-09T11:19:35.225571,52.5499116667,13.3725833333, 2christianWall, w,0.0026438957852482,43,88,114,12058,3596,884,100,24,9,1919,43,45,26
2020-12-09T11:19:36.243356,52.549925,13.37253, 2christianWall, w,0.0026438957852482,42,91,118,12136,3615,1050,106,24,9,1919,42,49,27
2020-12-09T11:19:37.261891,52.5499416667,13.372475, 2christianWall, w,0.0026438957852482,43,91,119,12348,3643,1060,104,27,9,1919,43,48,28
2020-12-09T11:19:38.295611,52.549955000000004,13.372416666700001, 2christianWall, w,0.0043021424111188,45,95,122,12638,3683,1062,106,26,8,1919,45,50,27
2020-12-09T11:19:39.326036,52.549965,13.372368333299999, 2christianWall, w,0.0043021424111188,47,95,122,12871,3711,1074,102,26,8,1919,47,48,27
2020-12-09T11:19:40.328449,52.5499766667,13.372323333299999, 2christianWall, w,0.0043021424111188,45,94,121,12548,3671,1074,100,26,9,1919,45,49,27
2020-12-09T11:19:41.355938,52.5499933333,13.372275, 2christianWall, w,0.0043021424111188,46,92,116,12653,3691,1076,88,23,8,1919,46,46,24
2020-12-09T11:19:42.374265,52.55001,13.372228333299999, 2christianWall, w,0.0043021424111188,46,92,111,12811,3703,1070,82,19,5,1919,46,46,19
2020-12-09T11:19:43.392014,52.550025,13.372176666700001, 2christianWall, w,0.0043021424111188,45,90,107,12366,3644,1062,82,19,5,1919,45,45,17
2020-12-09T11:19:44.409563,52.550043333299996,13.372125, 2christianWall, w,0.0043021424111188,48,94,110,12829,3693,1080,90,15,5,1919,48,46,16
2020-12-09T11:19:45.429318,52.5500616667,13.3720733333, 2christianWall, w,0.0043021424111188,48,97,115,12865,3709,1092,100,19,6,1919,48,49,18
2020-12-09T11:19:47.476147,52.5501083333,13.3719283333, 2christianWall, w,0.0053086212090555,46,96,114,12617,3680,1076,102,19,5,1919,46,50,18
2020-12-09T11:19:48.490214,52.55011999999999,13.371885, 2christianWall, w,0.0053086212090555,45,91,108,12339,3631,1048,94,17,6,1919,45,46,17
2020-12-09T11:19:49.507202,52.550131666700004,13.371839999999999, 2christianWall, w,0.0053086212090555,43,89,109,12049,3587,1048,94,22,7,1919,43,46,20
2020-12-09T11:19:50.522256,52.5501466667,13.3717983333, 2christianWall, w,0.0053086212090555,43,91,114,12139,3628,1058,100,23,8,1919,43,48,23
2020-12-09T11:19:51.554453,52.5501566667,13.371761666700001, 2christianWall, w,0.0053086212090555,45,98,117,12548,3670,1074,108,21,7,1919,45,53,19
2020-12-09T11:19:52.575724,52.5501666667,13.371725, 2christianWall, w,0.0053086212090555,45,99,118,12572,3664,1072,110,21,7,1919,45,54,19
2020-12-09T11:19:53.594448,52.550175,13.371685000000001, 2christianWall, w,0.0053086212090555,43,93,116,12073,3455,1050,106,23,7,1919,43,50,23
2020-12-09T11:19:54.609084,52.550180000000005,13.3716466667, 2christianWall, w,0.0053086212090555,43,95,118,12106,3605,1050,110,25,8,1919,43,52,23
2020-12-09T11:19:55.653313,52.55019,13.3716, 2christianWall, w,0.0034264855434065,42,95,115,12124,3627,1056,106,22,5,1919,42,53,20
2020-12-09T11:19:56.663937,52.550194999999995,13.371568333299999, 2christianWall, w,0.0034264855434065,45,98,115,12623,3846,1078,100,17,4,1919,45,53,17
2020-12-09T11:19:57.682213,52.5502066667,13.371533333299999, 2christianWall, w,0.0034264855434065,45,97,115,12590,3700,1076,96,19,5,1919,45,52,18
2020-12-09T11:19:58.699708,52.550215,13.3714966667, 2christianWall, w,0.0034264855434065,44,97,114,12393,3674,1068,100,19,4,1919,44,53,17
2020-12-09T11:19:59.728911,52.5502266667,13.3714583333, 2christianWall, w,0.0034264855434065,44,97,114,12393,3674,1068,100,19,4,1919,44,53,17
2020-12-09T11:20:00.752181,52.5502383333,13.3714183333, 2christianWall, w,0.0034264855434065,42,97,117,12375,3670,1074,106,17,6,1919,42,55,20
2020-12-09T11:20:01.769978,52.5502516667,13.371383333299999, 2christianWall, w,0.0034264855434065,44,100,117,12551,3674,1086,110,16,5,1919,44,56,17
2020-12-09T11:20:02.786035,52.5502633333,13.371343333299999, 2christianWall, w,0.0034264855434065,45,97,115,12641,3707,1074,98,16,6,1919,45,52,18
2020-12-09T11:20:03.827813,52.5502816667,13.3713066667, 2christianWall, w,0.0031855838546401,43,93,115,12330,3667,1060,100,19,9,1919,43,50,22
2020-12-09T11:20:04.831143,52.5503,13.3712683333, 2christianWall, w,0.0031855838546401,46,97,117,12659,3857,1074,106,16,9,1919,46,51,20
2020-12-09T11:20:05.849347,52.5503133333,13.371236666700002, 1startpulse, w,0.0031855838546401,48,96,115,13077,3894,1060,96,14,8,1919,48,48,19
2020-12-09T11:20:06.871122,52.5503266667,13.371208333299998, 1startpulse, w,0.0031855838546401,46,91,113,12817,3847,1034,86,17,9,1919,46,45,22
2020-12-09T11:20:07.887661,52.5503416667,13.371179999999999, 1startpulse, w,0.0031855838546401,45,93,114,12623,3685,1046,88,18,10,1919,45,48,21
2020-12-09T11:20:08.906458,52.5503566667,13.371151666700001, 1startpulse, w,0.0031855838546401,46,93,111,12668,3697,1034,84,14,9,1919,46,47,18
2020-12-09T11:20:09.928067,52.5503733333,13.3711266667, 1startpulse, w,0.0031855838546401,48,94,114,13313,3900,1052,82,14,9,1919,48,46,20
2020-12-09T11:20:10.953971,52.55039,13.371096666700002, 1startpulse, w,0.0031855838546401,48,92,107,13080,3875,1042,74,11,6,1919,48,44,15
2020-12-09T11:20:11.996995,52.55041,13.371075, 1startpulse, sw,0.0030270421136028,45,86,105,12593,3674,886,74,12,7,1919,45,41,19
2020-12-09T11:20:13.000770,52.550430000000006,13.371054999999998, 1startpulse, sw,0.0030270421136028,42,84,102,12040,3447,882,76,12,6,1919,42,42,18
2020-12-09T11:20:14.009470,52.55045,13.3710366667, 1startpulse, sw,0.0030270421136028,45,92,111,12623,3680,1056,82,14,8,1919,45,47,19
2020-12-09T11:20:15.017738,52.55047,13.371015, 1startpulse, sw,0.0030270421136028,47,95,115,13128,3891,1090,84,14,8,1919,47,48,20
2020-12-09T11:20:16.026199,52.5504916667,13.3709916667, 1startpulse, sw,0.0030270421136028,48,96,115,13128,3891,1090,84,14,8,1919,48,48,19
2020-12-09T11:20:17.048189,52.5505183333,13.370975, 1startpulse, sw,0.0030270421136028,48,94,115,13128,3883,1090,84,14,8,1919,48,46,21
2020-12-09T11:20:18.066637,52.550534999999996,13.370958333299999, 1startpulse, sw,0.0030270421136028,49,97,117,13582,3944,1086,88,12,7,1919,49,48,20
2020-12-09T11:20:19.095207,52.5505533333,13.3709466667, 1startpulse, sw,0.0025924003029528,49,93,116,13436,3933,1062,90,16,7,1919,49,44,23
2020-12-09T11:20:20.108136,52.5505716667,13.3709383333, 1startpulse, sw,0.0025924003029528,49,93,116,13418,3933,1068,92,16,7,1919,49,44,23
2020-12-09T11:20:21.116443,52.5505833333,13.3709316667, 1startpulse, sw,0.0025924003029528,49,95,118,13370,3933,1076,90,16,8,1919,49,46,23
2020-12-09T11:20:22.138226,52.5505883333,13.37093, 1startpulse, sw,0.0025924003029528,52,96,118,13663,4106,1056,92,16,8,1919,52,44,22
2020-12-09T11:20:23.154823,52.5505966667,13.370915, 1startpulse, sw,0.0025924003029528,53,98,122,14150,4177,1094,88,18,8,1919,53,45,24
2020-12-09T11:20:24.171493,52.5505933333,13.3709033333, 1startpulse, sw,0.0025924003029528,54,101,122,14416,4213,1102,86,17,8,1919,54,47,21
2020-12-09T11:20:25.190029,52.55059,13.3709016667, 1startpulse, sw,0.0025924003029528,53,100,117,14144,4165,1094,88,12,3,1919,53,47,17
2020-12-09T11:20:26.206305,52.55059,13.3709016667, 1startpulse, sw,0.0025924003029528,53,101,120,14428,4208,1096,90,15,6,1919,53,48,19
2020-12-09T11:20:27.239971,52.55059,13.3709016667, 1startpulse, sw,0.00072668513107426,54,104,122,14652,4388,1110,90,14,6,1919,54,50,18
2020-12-09T11:20:28.267433,52.550575,13.3708916667, 1startpulse, sw,0.00072668513107426,54,106,124,14676,4394,1140,88,16,9,1919,54,52,18
2020-12-09T11:20:29.289630,52.5505633333,13.3708833333, 1startpulse, sw,0.00072668513107426,55,111,127,14966,4451,1302,90,14,9,1919,55,56,16
2020-12-09T11:20:30.307135,52.5505633333,13.3708833333, 1startpulse, sw,0.00072668513107426,57,113,256,15378,4622,1312,88,13,9,1919,57,56,143
2020-12-09T11:20:31.311663,52.550556666700004,13.370876666700001, 1startpulse, sw,0.00072668513107426,55,110,126,15142,4459,1298,90,13,8,1919,55,55,16
2020-12-09T11:20:32.334761,52.550556666700004,13.370876666700001, 1startpulse, sw,0.00072668513107426,55,110,126,15142,4459,1298,90,13,8,1919,55,55,16
2020-12-09T11:20:33.352486,52.550556666700004,13.370876666700001, 1startpulse, sw,0.00072668513107426,53,109,123,14619,4386,1294,86,14,8,1919,53,56,14
2020-12-09T11:20:34.370691,52.550556666700004,13.370876666700001, 1startpulse, sw,0.00072668513107426,52,110,124,14395,4362,1146,98,14,8,1919,52,58,14
2020-12-09T11:20:35.406678,52.550556666700004,13.370876666700001, 1startpulse, nw,0.00058206902763043,54,114,260,14924,4463,1296,106,17,9,1919,54,60,146
2020-12-09T11:20:36.409788,52.550556666700004,13.370876666700001, 1startpulse, nw,0.00058206902763043,55,111,258,14876,4458,1150,96,17,9,1919,55,56,147
2020-12-09T11:20:37.434583,52.550556666700004,13.370876666700001, 1startpulse, nw,0.00058206902763043,53,106,120,14099,4215,1110,90,14,6,1919,53,53,14
2020-12-09T11:20:39.452865,52.550556666700004,13.370876666700001, 1startpulse, nw,0.00058206902763043,49,102,120,13388,4108,1088,94,17,7,1919,49,53,18
2020-12-09T11:20:40.469246,52.550556666700004,13.370876666700001, 1startpulse, nw,0.00058206902763043,46,102,118,12871,3897,1080,98,15,4,1919,46,56,16
2020-12-09T11:20:41.490435,52.550556666700004,13.370876666700001, 1startpulse, nw,0.00058206902763043,46,96,115,12393,3702,1040,94,17,6,1919,46,50,19
2020-12-09T11:20:42.507962,52.550556666700004,13.370876666700001, 1startpulse, nw,0.00058206902763043,45,97,117,12315,3678,1048,98,17,6,1919,45,52,20
2020-12-09T11:20:43.538328,52.550556666700004,13.370876666700001, 1startpulse, n,0.0,45,97,117,12291,3666,1038,98,17,7,1919,45,52,20
2020-12-09T11:20:44.545987,52.550556666700004,13.370876666700001, 1startpulse, n,0.0,46,101,119,12548,3702,1060,106,16,7,1919,46,55,18
2020-12-09T11:20:45.554815,52.550556666700004,13.370876666700001, 1startpulse, n,0.0,46,97,111,12390,3687,1050,92,13,6,1919,46,51,14
2020-12-09T11:20:46.576929,52.550556666700004,13.370876666700001, 1startpulse, n,0.0,46,94,106,12294,3653,892,86,11,5,1919,46,48,12
2020-12-09T11:20:47.595111,52.550556666700004,13.370876666700001, 1startpulse, n,0.0,46,94,106,12294,3653,892,86,11,5,1919,46,48,12
2020-12-09T11:20:48.613026,52.550556666700004,13.370876666700001, 1startpulse, n,0.0,46,93,109,12348,3660,892,86,14,8,1919,46,47,16
2020-12-09T11:20:49.630296,52.550556666700004,13.370876666700001, 1startpulse, n,0.0,46,93,109,12348,3660,892,86,14,8,1919,46,47,16
2020-12-09T11:20:50.647775,52.550556666700004,13.370876666700001, 1startpulse, n,0.0,48,96,111,12889,3864,1046,84,14,8,1919,48,48,15
2020-12-09T11:20:51.679974,52.550556666700004,13.370876666700001, 1startpulse, n,0.0,52,101,115,13693,4122,1086,84,12,8,1919,52,49,14
2020-12-09T11:20:52.697771,52.550556666700004,13.370876666700001, 1startpulse, n,0.0,53,100,114,13926,4152,1056,84,12,9,1919,53,47,14
2020-12-09T11:20:53.714068,52.550556666700004,13.370876666700001, 1startpulse, n,0.0,57,105,114,14643,4383,1096,82,8,6,1919,57,48,9
2020-12-09T11:20:54.736324,52.5505533333,13.370875, 1startpulse, n,0.0,55,102,114,14595,4366,1092,76,11,9,1919,55,47,12
2020-12-09T11:20:55.750985,52.55055,13.370875, 1startpulse, n,0.0,57,102,117,14655,4389,1118,74,11,9,1919,57,45,15
2020-12-09T11:20:56.765814,52.55055,13.370875, 1startpulse, n,0.0,57,102,118,14679,4393,1122,74,12,9,1919,57,45,16
2020-12-09T11:20:57.785892,52.55055,13.370875, 1startpulse, n,0.0,57,105,119,14616,4371,1116,80,12,9,1919,57,48,14
2020-12-09T11:20:58.800247,52.55055,13.370875, 1startpulse, n,0.0,55,105,120,14434,4367,1134,82,14,9,1919,55,50,15
2020-12-09T11:20:59.828315,52.55055,13.370875, 1startpulse, n,0.00010678875481514,55,104,117,14129,4186,1126,80,12,6,1919,55,49,13
2020-12-09T11:21:00.831050,52.5505466667,13.370875, 1startpulse, n,0.00010678875481514,49,94,107,12826,3854,1060,76,12,6,1919,49,45,13
2020-12-09T11:21:01.854246,52.55055,13.370875, 1startpulse, n,0.00010678875481514,46,88,102,12079,3606,1024,78,12,6,1919,46,42,14
2020-12-09T11:21:02.864406,52.5505483333,13.370873333299999, 1startpulse, n,0.00010678875481514,43,84,95,11786,3420,882,72,11,5,1919,43,41,11
2020-12-09T11:21:03.888669,52.550556666700004,13.370873333299999, 1startpulse, n,0.00010678875481514,38,74,85,10355,3090,816,64,10,5,1919,38,36,11
2020-12-09T11:21:04.907361,52.550558333299996,13.370873333299999, 1startpulse, n,0.00010678875481514,35,68,76,9745,2855,634,59,7,2,1919,35,33,8
2020-12-09T11:21:05.922954,52.5505616667,13.370871666700001, 1startpulse, n,0.00010678875481514,35,68,76,9745,2855,634,59,7,2,1919,35,33,8
2020-12-09T11:21:06.939423,52.5505616667,13.370870000000002, 1startpulse, n,0.00010678875481514,33,63,70,8965,2589,574,54,6,1,1919,33,30,7
2020-12-09T11:21:07.968949,52.550565,13.370871666700001, 1startpulse, s,0.00023993955362807998,33,63,70,8965,2589,574,54,6,1,1919,33,30,7
2020-12-09T11:21:08.995983,52.5505683333,13.370875, 1startpulse, s,0.00023993955362807998,33,64,71,9001,2595,574,58,6,1,1919,33,31,7
2020-12-09T11:21:10.004584,52.550575,13.370878333299999, 1startpulse, s,0.00023993955362807998,32,63,72,9040,2630,580,56,7,2,1919,32,31,9
2020-12-09T11:21:11.013781,52.5505783333,13.370876666700001, 1startpulse, s,0.00023993955362807998,32,66,77,9240,2648,598,68,9,2,1919,32,34,11
2020-12-09T11:21:12.035635,52.5505883333,13.370878333299999, 1startpulse, s,0.00023993955362807998,33,67,79,9330,2680,598,70,9,2,1919,33,34,12
2020-12-09T11:21:13.055740,52.5506,13.370878333299999, 1startpulse, s,0.00023993955362807998,36,72,84,10050,2919,632,70,9,2,1919,36,36,12
2020-12-09T11:21:14.079855,52.550615,13.370875, 1startpulse, s,0.00023993955362807998,37,75,85,10250,3086,772,66,9,2,1919,37,38,10
2020-12-09T11:21:15.111464,52.5506266667,13.370876666700001, 1startpulse, s,0.00098080014693803,37,78,91,10292,3106,798,76,12,3,1919,37,41,13
2020-12-09T11:21:16.127836,52.5506366667,13.370871666700001, 1startpulse, s,0.00098080014693803,40,83,97,11060,3347,834,82,12,3,1919,40,43,14
2020-12-09T11:21:17.144864,52.55065,13.370871666700001, 1startpulse, s,0.00098080014693803,44,88,104,11798,3452,870,85,13,3,1919,44,44,16
2020-12-09T11:21:18.161470,52.5506633333,13.370868333299999, 1startpulse, s,0.00098080014693803,45,92,109,12139,3645,1026,90,14,3,1919,45,47,17
2020-12-09T11:21:19.196825,52.550675,13.370866666700001, 1startpulse, s,0.00098080014693803,45,88,104,12058,3633,882,78,13,3,1919,45,43,16
2020-12-09T11:21:20.198132,52.55068000000001,13.370865, 1startpulse, s,0.00098080014693803,45,89,104,12342,3659,878,78,13,2,1919,45,44,15
2020-12-09T11:21:21.224271,52.5506783333,13.370861666700002, 1startpulse, s,0.00098080014693803,42,80,89,11559,3395,812,60,8,2,1919,42,38,9
2020-12-09T11:21:22.251397,52.5506733333,13.370861666700002, 1startpulse, s,0.00098080014693803,40,78,87,11275,3341,806,56,7,2,1919,40,38,9
2020-12-09T11:21:23.305697,52.550665,13.370854999999999, 1startpulse, sw,0.0006438825178517701,39,75,83,10830,3147,790,56,7,2,1919,39,36,8
2020-12-09T11:21:24.309845,52.5506583333,13.3708483333, 1startpulse, sw,0.0006438825178517701,39,75,83,10830,3147,790,56,7,2,1919,39,36,8
2020-12-09T11:21:25.318395,52.550655000000006,13.3708433333, 1startpulse, sw,0.0006438825178517701,39,74,82,11036,3159,794,49,6,1,1919,39,35,8
2020-12-09T11:21:26.327005,52.5506516667,13.3708383333, 1startpulse, sw,0.0006438825178517701,39,72,77,10824,3147,768,43,4,0,1919,39,33,5
2020-12-09T11:21:27.349582,52.5506433333,13.370833333299998, 1startpulse, sw,0.0006438825178517701,41,73,78,11054,3170,778,47,4,0,1919,41,32,5
2020-12-09T11:21:28.366745,52.550635,13.370823333299999, 1startpulse, sw,0.0006438825178517701,39,77,81,10869,3166,794,53,4,1,1919,39,38,4
2020-12-09T11:21:29.385835,52.5506283333,13.370821666700001, 1startpulse, sw,0.0006438825178517701,43,82,87,11801,3445,838,53,4,1,1919,43,39,5
2020-12-09T11:21:30.402302,52.550619999999995,13.370821666700001, 1startpulse, sw,0.0006438825178517701,46,87,92,12046,3604,848,55,5,1,1919,46,41,5
2020-12-09T11:21:31.423065,52.5506166667,13.370818333299999, 1startpulse, nw,0.00084554543294086,46,87,94,11876,3602,860,55,5,2,1919,46,41,7
2020-12-09T11:21:33.449598,52.5506083333,13.3708016667, 1startpulse, nw,0.00084554543294086,50,94,103,12847,3872,1046,61,6,2,1919,50,44,9
2020-12-09T11:21:36.467171,52.5505883333,13.370770000000002, 1startpulse, nw,0.00084554543294086,52,97,106,13624,4137,1070,61,7,2,1919,52,45,9
2020-12-09T11:21:37.484485,52.5505883333,13.370766666700002, 1startpulse, nw,0.00084554543294086,58,109,118,14882,4475,1147,67,8,2,1919,58,51,9
2020-12-09T11:21:38.501826,52.550585,13.3707616667, 1startpulse, nw,0.00084554543294086,58,106,116,14652,4442,1111,70,8,2,1919,58,48,10
2020-12-09T11:21:39.534559,52.5505816667,13.3707566667, 1startpulse, nw,0.0008148605237810401,58,106,118,14903,4468,1123,68,8,3,1919,58,48,12
2020-12-09T11:21:40.538627,52.5505783333,13.3707516667, 1startpulse, nw,0.0008148605237810401,57,101,114,14458,4411,1103,60,9,3,1919,57,44,13
2020-12-09T11:21:41.547291,52.5505733333,13.3707466667, 1startpulse, nw,0.0008148605237810401,57,101,114,14458,4411,1103,60,9,3,1919,57,44,13
2020-12-09T11:21:42.569429,52.55056999999999,13.3707416667, 1startpulse, nw,0.0008148605237810401,56,99,110,14368,4373,1087,54,8,2,1919,56,43,11
2020-12-09T11:21:43.589322,52.5505666667,13.370736666700001, 1startpulse, nw,0.0008148605237810401,56,99,110,14368,4373,1087,54,8,2,1919,56,43,11
2020-12-09T11:21:44.606058,52.5505633333,13.370731666700001, 1startpulse, nw,0.0008148605237810401,53,93,108,13660,4132,1061,54,12,3,1919,53,40,15
2020-12-09T11:21:45.625062,52.550558333299996,13.370726666700001, 1startpulse, nw,0.0008148605237810401,53,93,108,13660,4132,1061,54,12,3,1919,53,40,15
2020-12-09T11:21:46.640877,52.550555,13.370721666700002, 1startpulse, nw,0.0008148605237810401,50,88,102,13149,3919,1031,50,12,4,1919,50,38,14
2020-12-09T11:21:47.674234,52.5505516667,13.3707166667, 1startpulse, nw,0.00061345469198136,50,88,102,13149,3919,1031,50,12,4,1919,50,38,14
2020-12-09T11:21:48.688352,52.5505483333,13.37071, 1startpulse, nw,0.00061345469198136,49,87,98,12826,3858,893,48,11,3,1919,49,38,11
2020-12-09T11:21:49.710570,52.55054499999999,13.370705, 1startpulse, nw,0.00061345469198136,46,81,96,12402,3671,863,44,13,3,1919,46,35,15
2020-12-09T11:21:50.728036,52.550540000000005,13.3707, 1startpulse, nw,0.00061345469198136,44,80,100,12052,3586,859,58,19,8,1919,44,36,20
2020-12-09T11:21:51.748952,52.5505366667,13.370695000000001, 1startpulse, nw,0.00061345469198136,39,72,93,11084,3172,800,62,21,8,1919,39,33,21
2020-12-09T11:21:54.773464,52.5505516667,13.3705583333, 1startpulse, nw,0.00061345469198136,37,74,95,10821,3130,814,68,22,9,1919,37,37,21
2020-12-09T11:21:55.799903,52.55054499999999,13.370545000000002, 1startpulse, w,0.0016614645843342,37,74,95,10776,3124,810,68,22,9,1919,37,37,21
2020-12-09T11:21:56.815922,52.5505433333,13.370525, 1startpulse, w,0.0016614645843342,35,71,92,10310,2929,804,70,22,9,1919,35,36,21
2020-12-09T11:21:57.831656,52.5505416667,13.370503333299999, 1startpulse, w,0.0016614645843342,35,69,91,10074,2893,782,72,23,10,1919,35,34,22
2020-12-09T11:21:58.849268,52.5505416667,13.3704833333, 1startpulse, w,0.0016614645843342,32,68,87,9766,2839,636,70,18,9,1919,32,36,19
2020-12-09T11:21:59.865217,52.550540000000005,13.3704616667, 1startpulse, w,0.0016614645843342,33,68,85,9802,2845,770,67,17,8,1919,33,35,17
2020-12-09T11:22:00.881460,52.5505383333,13.370439999999999, 1startpulse, w,0.0016614645843342,31,65,80,9243,2626,616,67,17,8,1919,31,34,15
2020-12-09T11:22:01.897110,52.5505366667,13.3704183333, 1startpulse, w,0.0016614645843342,28,62,80,8556,2419,612,73,19,9,1919,28,34,18
2020-12-09T11:22:02.913401,52.5505366667,13.370396666700001, 1startpulse, w,0.0016614645843342,27,59,73,8045,2345,586,69,15,4,1919,27,32,14
2020-12-09T11:22:03.939415,52.550534999999996,13.370375, 1startpulse, w,0.0016496880904649,27,59,73,8045,2345,586,69,15,4,1919,27,32,14
2020-12-09T11:22:04.961005,52.5505333333,13.370354999999998, 1startpulse, w,0.0016496880904649,28,62,75,8302,2386,606,69,12,4,1919,28,34,13
2020-12-09T11:22:05.976456,52.5505316667,13.3703333333, 1startpulse, w,0.0016496880904649,29,65,78,8723,2565,626,67,14,3,1919,29,36,13
2020-12-09T11:22:06.992748,52.5505316667,13.370311666700001, 1startpulse, w,0.0016496880904649,29,66,80,8968,2598,784,71,14,3,1919,29,37,14
2020-12-09T11:22:08.024188,52.5505733333,13.3703383333, 1startpulse, w,0.0016496880904649,31,68,83,9479,2681,794,69,13,3,1919,31,37,15
2020-12-09T11:22:09.020172,52.55059,13.3703816667, 1startpulse, w,0.0016496880904649,33,77,90,10002,2906,846,75,12,2,1919,33,44,13
2020-12-09T11:22:10.034155,52.55055,13.3704266667, 1startpulse, w,0.0016496880904649,36,79,95,10355,3104,880,83,13,3,1919,36,43,16
2020-12-09T11:22:11.068804,52.5505216667,13.3704566667, 1startpulse, e,0.0008166643124272,37,83,100,10618,3152,1028,92,14,3,1919,37,46,17
2020-12-09T11:22:12.085451,52.5504916667,13.370479999999999, 1startpulse, e,0.0008166643124272,41,91,110,11786,3440,1088,98,15,3,1919,41,50,19
2020-12-09T11:22:13.102119,52.5504633333,13.370505, 1startpulse, e,0.0008166643124272,41,92,106,11810,3443,1088,90,10,2,1919,41,51,14
2020-12-09T11:22:14.118370,52.5504866667,13.3705166667, 1startpulse, e,0.0008166643124272,44,93,109,12318,3641,1092,90,10,2,1919,44,49,16
2020-12-09T11:22:15.134775,52.550484999999995,13.370525, 1startpulse, e,0.0008166643124272,43,89,104,11903,3588,1066,84,10,2,1919,43,46,15
2020-12-09T11:22:16.152410,52.5504833333,13.3705333333, 1startpulse, e,0.0008166643124272,41,87,104,11798,3431,1052,88,10,5,1919,41,46,17
2020-12-09T11:22:17.170274,52.5504816667,13.370541666700001, 1startpulse, e,0.0008166643124272,40,88,103,11529,3386,1038,90,9,4,1919,40,48,15
2020-12-09T11:22:18.185612,52.55048000000001,13.37055, 1startpulse, e,0.0008166643124272,40,88,103,11529,3386,1038,90,9,4,1919,40,48,15
2020-12-09T11:22:19.217729,52.5504783333,13.3705583333, 1startpulse, ne,0.0011993144168707,39,84,103,11078,3192,890,94,12,7,1919,39,45,19
2020-12-09T11:22:20.239515,52.5504766667,13.3705666667, 1startpulse, ne,0.0011993144168707,37,83,103,11009,3159,876,94,13,7,1919,37,46,20
2020-12-09T11:22:21.261135,52.5505066667,13.370535, 1startpulse, ne,0.0011993144168707,37,79,95,10788,3109,834,84,12,6,1919,37,42,16
2020-12-09T11:22:22.278158,52.5505266667,13.3705116667, 1startpulse, ne,0.0011993144168707,36,78,94,10603,3103,816,82,11,6,1919,36,42,16
2020-12-09T11:22:23.295655,52.55053,13.3705083333, 1startpulse, ne,0.0011993144168707,36,72,87,10286,2902,784,72,11,6,1919,36,36,15
2020-12-09T11:22:24.313334,52.5505233333,13.370501666700001, 1startpulse, ne,0.0011993144168707,36,76,92,10558,3076,800,84,12,6,1919,36,40,16
2020-12-09T11:22:25.331751,52.550525,13.370501666700001, 1startpulse, ne,0.0011993144168707,36,80,97,10761,3101,836,92,14,6,1919,36,44,17
2020-12-09T11:22:26.349582,52.5505283333,13.370501666700001, 1startpulse, ne,0.0011993144168707,37,86,106,11066,3156,870,110,19,6,1919,37,49,20
2020-12-09T11:22:27.384028,52.5505316667,13.370501666700001, 1startpulse, sw,0.0010087203061408,39,87,105,11335,3195,872,106,17,4,1919,39,48,18
2020-12-09T11:22:28.387834,52.5505333333,13.370501666700001, 1startpulse, sw,0.0010087203061408,40,84,104,11568,3349,864,95,17,4,1919,40,44,20
2020-12-09T11:22:29.409481,52.5505366667,13.370503333299999, 1startpulse, sw,0.0010087203061408,40,86,105,11780,3391,878,93,17,4,1919,40,46,19
2020-12-09T11:22:30.426851,52.5505383333,13.370503333299999, 1startpulse, sw,0.0010087203061408,41,84,103,11640,3395,864,89,16,4,1919,41,43,19
2020-12-09T11:22:32.445254,52.55045500000001,13.3705616667, 1startpulse, sw,0.0010087203061408,42,89,107,12061,3596,1032,95,16,4,1919,42,47,18
2020-12-09T11:22:33.464985,52.5504516667,13.3705683333, 1startpulse, sw,0.0010087203061408,42,89,107,12061,3596,1032,95,16,4,1919,42,47,18
2020-12-09T11:22:34.486908,52.5504483333,13.3705733333, 1startpulse, sw,0.0010087203061408,42,90,110,12085,3592,1044,99,17,4,1919,42,48,20
2020-12-09T11:22:35.498095,52.5504466667,13.370579999999999, 1startpulse, ne,0.0015477537737113,42,90,110,12085,3592,1044,99,17,4,1919,42,48,20
2020-12-09T11:22:36.518621,52.5504433333,13.370585, 1startpulse, ne,0.0015477537737113,44,93,113,12342,3643,1058,99,16,4,1919,44,49,20
2020-12-09T11:22:37.540209,52.55044,13.370591666700001, 1startpulse, ne,0.0015477537737113,44,93,113,12342,3643,1058,99,16,4,1919,44,49,20
2020-12-09T11:22:38.558056,52.5504366667,13.370598333299998, 1startpulse, ne,0.0015477537737113,44,91,111,12572,3673,1060,87,16,5,1919,44,47,20
2020-12-09T11:22:39.575793,52.5504333333,13.3706033333, 1startpulse, ne,0.0015477537737113,43,83,97,11825,3429,872,67,11,5,1919,43,40,14
2020-12-09T11:22:40.592881,52.550430000000006,13.370610000000001, 1startpulse, ne,0.0015477537737113,39,71,82,10567,3117,806,44,6,5,1919,39,32,11
2020-12-09T11:22:41.610145,52.5504266667,13.370614999999999, 1startpulse, ne,0.0015477537737113,35,63,73,9533,2837,638,37,5,4,1919,35,28,10
2020-12-09T11:22:42.627530,52.550423333299996,13.3706216667, 1startpulse, ne,0.0015477537737113,32,62,69,8974,2628,638,38,5,4,1919,32,30,7
2020-12-09T11:22:43.660517,52.550421666700004,13.370626666700002, 1startpulse, ne,0.00060072980427369,33,63,71,9034,2644,778,42,5,1,1919,33,30,8
2020-12-09T11:22:44.678316,52.5504183333,13.370633333299999, 1startpulse, ne,0.00060072980427369,33,63,71,9243,2673,788,36,5,1,1919,33,30,8
2020-12-09T11:22:45.695737,52.550415,13.370638333299999, 1startpulse, ne,0.00060072980427369,32,63,69,8998,2644,782,36,6,1,1919,32,31,6
2020-12-09T11:22:46.712398,52.5504116667,13.370645000000001, 1startpulse, ne,0.00060072980427369,32,64,69,8968,2644,778,30,5,1,1919,32,32,5
