Time,lat,long,d,Direction,f,PM1.0,PM2.5,PM10.0,0.3μm,0.5μm,1.0μm,2.5μm,5.0μm,10.0μm,p,1.0,2.5,10.0
2020-12-15T12:19:19.943094,52.5487133333,13.368756666700001, 4homepulse, o,0.0,18,28,28,5439,1596,314,6,0,0,1919,18,10,0
2020-12-15T12:19:20.952105,52.5487183333,13.368766666700001, 4homepulse, o,0.0,17,28,28,5230,1566,319,6,0,0,1919,17,11,0
2020-12-15T12:19:21.961247,52.548721666700004,13.3687733333, 4homepulse, o,0.0,17,26,26,4985,1401,292,6,0,0,1919,17,9,0
2020-12-15T12:19:22.971071,52.548725,13.3687766667, 4homepulse, o,0.0,16,25,25,4985,1401,292,6,0,0,1919,16,9,0
2020-12-15T12:19:23.981152,52.5487266667,13.3687766667, 4homepulse, o,0.0,16,24,24,4949,1391,282,2,0,0,1919,16,8,0
2020-12-15T12:19:24.991998,52.5487266667,13.3687766667, 4homepulse, o,0.0,16,24,24,4949,1391,282,2,0,0,1919,16,8,0
2020-12-15T12:19:26.003570,52.5487283333,13.368763333299999, 4homepulse, o,0.0,14,20,20,4471,1324,126,0,0,0,1919,14,6,0
2020-12-15T12:19:27.027527,52.5487566667,13.368770000000001, 3cobbleGroove2, w,0.0,14,20,20,4471,1324,126,0,0,0,1919,14,6,0
2020-12-15T12:19:28.046981,52.548675,13.368910000000001, 4homepulse, w,0.0,13,20,21,4465,1326,121,2,2,0,1919,13,7,1
2020-12-15T12:19:29.061186,52.5486533333,13.3688216667, 4homepulse, w,0.0,13,20,21,4465,1326,121,2,2,0,1919,13,7,1
2020-12-15T12:19:30.082616,52.5486466667,13.3687383333, 4homepulse, w,0.0,13,19,20,4450,1324,124,2,2,0,1919,13,6,1
2020-12-15T12:19:31.098931,52.548715,13.3685933333, 4homepulse, w,0.0,13,19,20,4450,1324,124,2,2,0,1919,13,6,1
2020-12-15T12:19:32.114137,52.54869,13.368628333299998, 4homepulse, w,0.0,14,20,21,4644,1356,257,2,2,0,1919,14,6,1
2020-12-15T12:19:33.129555,52.5486683333,13.368654999999999, 4homepulse, w,0.0,14,20,21,4644,1356,257,2,2,0,1919,14,6,1
2020-12-15T12:19:34.144741,52.548675,13.368654999999999, 4homepulse, nw,0.0017078663611196,14,20,21,4623,1348,124,2,2,0,1919,14,6,1
2020-12-15T12:19:35.160031,52.5486666667,13.3686983333, 4homepulse, nw,0.0017078663611196,14,20,21,4623,1348,124,2,2,0,1919,14,6,1
2020-12-15T12:19:36.182534,52.54865,13.3687416667, 4homepulse, nw,0.0017078663611196,15,21,22,4728,1376,267,4,2,0,1919,15,6,1
2020-12-15T12:19:37.197921,52.5486483333,13.368761666700001, 4homepulse, nw,0.0017078663611196,15,21,22,4728,1376,267,4,2,0,1919,15,6,1
2020-12-15T12:19:38.213052,52.5486483333,13.36878, 4homepulse, nw,0.0017078663611196,15,21,23,4910,1391,257,6,2,0,1919,15,6,2
2020-12-15T12:19:39.228698,52.5486516667,13.3687916667, 4homepulse, nw,0.0017078663611196,15,21,23,4910,1391,257,6,2,0,1919,15,6,2
2020-12-15T12:19:40.244932,52.5486533333,13.368795, 4homepulse, nw,0.0017078663611196,16,21,23,4985,1544,119,6,2,0,1919,16,5,2
2020-12-15T12:19:41.260429,52.54865,13.368801666700001, 4homepulse, nw,0.0017078663611196,16,21,23,4985,1544,119,6,2,0,1919,16,5,2
2020-12-15T12:19:42.276413,52.5486483333,13.3688, 4homepulse, e,0.0014633340400967,16,23,25,5179,1561,274,10,4,2,1919,16,7,2
2020-12-15T12:19:43.292544,52.5486416667,13.3687883333, 4homepulse, e,0.0014633340400967,16,23,25,5179,1561,274,10,4,2,1919,16,7,2
2020-12-15T12:19:44.309065,52.548633333299996,13.368775, 4homepulse, e,0.0014633340400967,15,23,27,5179,1553,274,12,6,4,1919,15,8,4
2020-12-15T12:19:45.334579,52.5486266667,13.368754999999998, 4homepulse, e,0.0014633340400967,15,23,27,5179,1553,274,12,6,4,1919,15,8,4
2020-12-15T12:19:46.351539,52.5486283333,13.3687383333, 4homepulse, e,0.0014633340400967,14,22,26,5185,1550,284,12,6,4,1919,14,8,4
2020-12-15T12:19:47.368355,52.54863,13.3687333333, 4homepulse, e,0.0014633340400967,14,22,26,5185,1550,284,12,6,4,1919,14,8,4
2020-12-15T12:19:48.384506,52.548633333299996,13.3687283333, 4homepulse, e,0.0014633340400967,15,22,25,5191,1550,294,10,4,4,1919,15,7,3
2020-12-15T12:19:49.401040,52.5486383333,13.3687216667, 4homepulse, e,0.0014633340400967,15,22,25,5191,1550,294,10,4,4,1919,15,7,3
2020-12-15T12:19:50.418500,52.5486433333,13.368715, 4homepulse, w,0.00082495553324332,14,22,25,5170,1542,306,10,4,4,1919,14,8,3
2020-12-15T12:19:51.434756,52.5486483333,13.368711666700001, 4homepulse, w,0.00082495553324332,14,22,25,5170,1542,306,10,4,4,1919,14,8,3
2020-12-15T12:19:52.451499,52.5486533333,13.368706666700001, 4homepulse, w,0.00082495553324332,13,22,25,4991,1392,319,10,4,4,1919,13,9,3
2020-12-15T12:19:53.468150,52.5486566667,13.3687033333, 4homepulse, w,0.00082495553324332,13,22,25,4991,1392,319,10,4,4,1919,13,9,3
2020-12-15T12:19:54.484747,52.54866,13.368701666700002, 4homepulse, w,0.00082495553324332,13,23,26,5179,1540,324,10,4,4,1919,13,10,3
2020-12-15T12:19:55.503070,52.5486633333,13.3686983333, 4homepulse, w,0.00082495553324332,13,23,26,5179,1540,324,10,4,4,1919,13,10,3
2020-12-15T12:19:56.520984,52.5486666667,13.3686933333, 4homepulse, w,0.00082495553324332,13,22,27,5164,1540,326,10,6,4,1919,13,9,5
2020-12-15T12:19:57.540841,52.548669999999994,13.3686916667, 4homepulse, w,0.00082495553324332,13,22,27,5164,1540,326,10,6,4,1919,13,9,5
2020-12-15T12:19:58.560883,52.5486716667,13.368689999999999, 4homepulse, sw,0.00051088232250685,13,22,28,5230,1567,334,10,8,4,1919,13,9,6
2020-12-15T12:19:59.583505,52.5486716667,13.3686916667, 4homepulse, sw,0.00051088232250685,13,22,28,5230,1567,334,10,8,4,1919,13,9,6
2020-12-15T12:20:00.603142,52.5486683333,13.368685000000001, 4homepulse, sw,0.00051088232250685,13,22,28,5170,1547,334,10,8,4,1919,13,9,6
2020-12-15T12:20:01.623279,52.5486583333,13.368666666700001, 4homepulse, sw,0.00051088232250685,13,22,28,5170,1547,334,10,8,4,1919,13,9,6
2020-12-15T12:20:02.648611,52.548705000000005,13.368565, 4homepulse, sw,0.00051088232250685,14,22,26,5215,1567,324,6,6,2,1919,14,8,4
2020-12-15T12:20:03.678901,52.5487716667,13.368329999999998, 3cobbleGroove2, sw,0.00051088232250685,14,22,26,5215,1567,324,6,6,2,1919,14,8,4
2020-12-15T12:20:04.703142,52.5490266667,13.368051666700001, 3cobbleGroove2, sw,0.00051088232250685,15,23,30,5430,1595,334,11,11,2,1919,15,8,7
2020-12-15T12:20:05.719415,52.549255,13.3677116667, 3cobbleGroove2, sw,0.00051088232250685,15,23,30,5430,1595,334,11,11,2,1919,15,8,7
2020-12-15T12:20:06.749146,52.5495,13.3673833333, none, sw,0.018232904432722,16,24,31,5672,1638,324,13,11,2,1919,16,8,7
2020-12-15T12:20:07.770145,52.5496266667,13.367285, none, sw,0.018232904432722,16,24,31,5672,1638,324,13,11,2,1919,16,8,7
2020-12-15T12:20:08.781019,52.549753333299996,13.3671783333, none, sw,0.018232904432722,16,24,30,5469,1626,311,13,11,2,1919,16,8,6
2020-12-15T12:20:09.805698,52.5498266667,13.3671016667, none, sw,0.018232904432722,16,24,30,5469,1626,311,13,11,2,1919,16,8,6
2020-12-15T12:20:10.823602,52.5497183333,13.367346666700001, none, sw,0.018232904432722,16,23,29,5499,1631,286,13,11,2,1919,16,7,6
2020-12-15T12:20:11.840507,52.5499,13.3671466667, none, sw,0.018232904432722,16,23,29,5499,1631,286,13,11,2,1919,16,7,6
2020-12-15T12:20:12.866025,52.5496783333,13.3675183333, 3cobbleGroove2, sw,0.018232904432722,16,22,29,5430,1606,278,13,11,2,1919,16,6,7
2020-12-15T12:20:13.882446,52.5496233333,13.367676666700001, 3cobbleGroove2, sw,0.018232904432722,16,22,29,5430,1606,278,13,11,2,1919,16,6,7
2020-12-15T12:20:14.899530,52.5496883333,13.3676533333, 3cobbleGroove2, se,0.0039688340124035,16,22,28,5430,1601,280,13,11,2,1919,16,6,6
2020-12-15T12:20:15.917145,52.549575,13.3678766667, 3cobbleGroove2, se,0.0039688340124035,16,22,28,5430,1601,280,13,11,2,1919,16,6,6
2020-12-15T12:20:17.942253,52.5496233333,13.367995, 3cobbleGroove2, se,0.0039688340124035,16,23,28,5439,1601,285,11,9,2,1919,16,7,5
2020-12-15T12:20:18.959673,52.54940500000001,13.368391666700001, 3cobbleGroove2, se,0.0039688340124035,16,23,28,5439,1601,285,11,9,2,1919,16,7,5
2020-12-15T12:20:19.977188,52.5493166667,13.3685966667, 3cobbleGroove2, se,0.0039688340124035,17,23,27,5475,1611,287,9,7,2,1919,17,6,4
2020-12-15T12:20:20.994081,52.5494066667,13.3685433333, 3cobbleGroove2, se,0.0039688340124035,17,23,27,5475,1611,287,9,7,2,1919,17,6,4
2020-12-15T12:20:22.011754,52.5494016667,13.36863, 3cobbleGroove2, se,0.0039688340124035,17,24,28,5708,1643,294,9,7,2,1919,17,7,4
2020-12-15T12:20:23.030128,52.549385,13.3687366667, 3cobbleGroove2, e,0.011520292214948,17,24,28,5708,1643,294,9,7,2,1919,17,7,4
2020-12-15T12:20:24.047526,52.5493716667,13.368839999999999, 3cobbleGroove2, e,0.011520292214948,17,23,27,5657,1616,289,9,7,2,1919,17,6,4
2020-12-15T12:20:25.065474,52.5493,13.3690183333, 3cobbleGroove2, e,0.011520292214948,17,23,27,5657,1616,289,9,7,2,1919,17,6,4
2020-12-15T12:20:26.082577,52.54919,13.369254999999999, 3cobbleGroove2, e,0.011520292214948,16,23,23,5463,1601,281,2,0,0,1919,16,7,0
2020-12-15T12:20:27.101712,52.5493333333,13.369126666700001, 3cobbleGroove2, e,0.011520292214948,16,23,23,5463,1601,281,2,0,0,1919,16,7,0
2020-12-15T12:20:28.120867,52.54942,13.369081666700001, 3cobbleGroove2, e,0.011520292214948,16,22,22,5403,1581,276,0,0,0,1919,16,6,0
2020-12-15T12:20:29.140943,52.5495516667,13.368970000000001, 3cobbleGroove2, e,0.011520292214948,16,22,22,5403,1581,276,0,0,0,1919,16,6,0
2020-12-15T12:20:30.154469,52.5496016667,13.368975, 3cobbleGroove2, e,0.011520292214948,16,24,24,5657,1613,296,0,0,0,1919,16,8,0
2020-12-15T12:20:31.176728,52.549505,13.3691916667, 3cobbleGroove2, e,0.0047905432492107,15,24,24,5445,1588,299,2,0,0,1919,15,9,0
2020-12-15T12:20:32.192883,52.549525,13.369233333299999, 3cobbleGroove2, e,0.0047905432492107,15,23,23,5460,1600,297,2,0,0,1919,15,8,0
2020-12-15T12:20:33.211545,52.549519999999994,13.369304999999999, 3cobbleGroove2, e,0.0047905432492107,15,25,25,5475,1613,312,4,0,0,1919,15,10,0
2020-12-15T12:20:34.239037,52.5495466667,13.3693366667, 3cobbleGroove2, e,0.0047905432492107,15,25,25,5639,1630,310,4,0,0,1919,15,10,0
2020-12-15T12:20:35.291754,52.5487516667,13.3710333333, 4homepulse, e,0.0047905432492107,15,25,25,5633,1625,305,4,0,0,1919,15,10,0
2020-12-15T12:20:36.306815,52.5487433333,13.371096666700002, 4homepulse, e,0.0047905432492107,16,27,27,5684,1630,313,8,0,0,1919,16,11,0
2020-12-15T12:20:37.323534,52.548735,13.371158333299999, 4homepulse, e,0.0047905432492107,16,28,28,5899,1657,333,8,0,0,1919,16,12,0
2020-12-15T12:20:38.339341,52.5487416667,13.371215, 4homepulse, e,0.0047905432492107,16,29,29,5908,1659,346,12,0,0,1919,16,13,0
2020-12-15T12:20:39.363605,52.54875500000001,13.3712716667, 4homepulse, e,0.023358170500254998,16,30,31,5989,1802,364,16,2,0,1919,16,14,1
2020-12-15T12:20:40.384601,52.548790000000004,13.371343333299999, 4homepulse, e,0.023358170500254998,16,29,30,5902,1647,362,16,2,0,1919,16,13,1
2020-12-15T12:20:41.400536,52.548795,13.371405, 4homepulse, e,0.023358170500254998,16,31,32,6171,1818,379,16,2,0,1919,16,15,1
2020-12-15T12:20:42.418138,52.548805,13.3714633333, 4homepulse, e,0.023358170500254998,17,32,33,6216,1828,514,18,2,0,1919,17,15,1
2020-12-15T12:20:43.440548,52.548809999999996,13.371516666700002, 4homepulse, e,0.023358170500254998,17,32,33,6216,1828,514,18,2,0,1919,17,15,1
2020-12-15T12:20:44.463542,52.5488283333,13.3715616667, 4homepulse, e,0.023358170500254998,17,30,31,6201,1825,364,16,2,0,1919,17,13,1
2020-12-15T12:20:45.479970,52.5488516667,13.3716, 4homepulse, e,0.023358170500254998,17,30,31,6201,1825,364,16,2,0,1919,17,13,1
2020-12-15T12:20:46.494639,52.5488716667,13.371635000000001, 4homepulse, e,0.023358170500254998,16,28,29,6007,1798,344,18,2,0,1919,16,12,1
2020-12-15T12:20:47.511813,52.5488883333,13.371670000000002, 4homepulse, e,0.0043920965271192,16,28,29,6007,1798,344,18,2,0,1919,16,12,1
2020-12-15T12:20:48.532575,52.5489083333,13.371713333299999, 4homepulse, e,0.0043920965271192,15,31,32,6171,1806,379,25,2,0,1919,15,16,1
2020-12-15T12:20:49.549031,52.5489083333,13.3717483333, 4homepulse, e,0.0043920965271192,16,32,33,6186,1818,522,25,2,0,1919,16,16,1
2020-12-15T12:20:50.565031,52.548894999999995,13.3717766667, 4homepulse, e,0.0043920965271192,16,32,34,6195,1823,517,27,2,0,1919,16,16,2
2020-12-15T12:20:51.580872,52.548875,13.3717983333, 4homepulse, e,0.0043920965271192,17,33,34,6470,1863,517,25,2,0,1919,17,16,1
2020-12-15T12:20:52.597239,52.5488283333,13.371804999999998, 4homepulse, e,0.0043920965271192,18,35,35,6679,1900,524,25,0,0,1919,18,17,0
2020-12-15T12:20:53.623373,52.54877,13.3717966667, 4homepulse, e,0.0043920965271192,19,36,36,6781,2062,536,25,0,0,1919,19,17,0
2020-12-15T12:20:54.655395,52.548721666700004,13.371789999999999, 4homepulse, e,0.0043920965271192,19,36,36,6924,2072,529,25,0,0,1919,19,17,0
2020-12-15T12:20:55.670766,52.5486816667,13.371789999999999, 4homepulse, ne,0.0034815479835132,19,36,36,6984,2087,537,23,0,0,1919,19,17,0
2020-12-15T12:20:56.689749,52.5486466667,13.3717966667, 4homepulse, ne,0.0034815479835132,19,38,38,7020,2090,549,27,0,0,1919,19,19,0
2020-12-15T12:20:57.706021,52.5486033333,13.3718, 4homepulse, ne,0.0034815479835132,20,40,42,7432,2139,574,29,2,2,1919,20,20,2
2020-12-15T12:20:58.723724,52.54857,13.37181, 4homepulse, ne,0.0034815479835132,20,38,39,7441,2143,544,22,2,2,1919,20,18,1
2020-12-15T12:20:59.744368,52.5485283333,13.371820000000001, 4homepulse, ne,0.0034815479835132,20,37,38,7187,2111,524,20,2,2,1919,20,17,1
2020-12-15T12:21:00.767909,52.5484883333,13.3718233333, 4homepulse, ne,0.0034815479835132,20,36,38,7029,2111,516,18,2,2,1919,20,16,2
2020-12-15T12:21:01.785158,52.548444999999994,13.371813333299999, 4homepulse, ne,0.0034815479835132,20,36,38,7029,2111,516,18,2,2,1919,20,16,2
2020-12-15T12:21:02.810897,52.548406666700004,13.371804999999998, 4homepulse, ne,0.0034815479835132,20,35,37,6993,2091,513,16,2,2,1919,20,15,2
2020-12-15T12:21:03.828378,52.54838,13.371811666700001, 4homepulse, n,0.0047965483018472,20,35,37,6993,2091,513,16,2,2,1919,20,15,2
2020-12-15T12:21:04.845592,52.5483583333,13.371818333299998, 4homepulse, n,0.0047965483018472,19,34,35,6775,2051,516,12,2,2,1919,19,15,1
2020-12-15T12:21:05.862444,52.54832,13.371816666700001, 4homepulse, n,0.0047965483018472,18,33,34,6775,2051,516,12,2,2,1919,18,15,1
2020-12-15T12:21:06.879870,52.54829,13.371808333299999, 4homepulse, n,0.0047965483018472,18,31,33,6718,1899,373,12,2,2,1919,18,13,2
2020-12-15T12:21:07.897612,52.548255000000005,13.371813333299999, 4homepulse, n,0.0047965483018472,18,31,33,6718,1899,373,12,2,2,1919,18,13,2
2020-12-15T12:21:08.914688,52.5482116667,13.371820000000001, 4homepulse, n,0.0047965483018472,18,31,33,6757,1916,370,10,2,2,1919,18,13,2
2020-12-15T12:21:10.931202,52.5480616667,13.371870000000001, 4homepulse, n,0.0047965483018472,19,32,34,6757,1916,370,10,2,2,1919,19,13,2
2020-12-15T12:21:11.964300,52.548005,13.371895, none, n,0.0060110170073501,20,32,34,6915,2062,370,10,2,2,1919,20,12,2
2020-12-15T12:21:12.981420,52.5479583333,13.371896666700001, none, n,0.0060110170073501,20,32,34,6915,2062,370,10,2,2,1919,20,12,2
2020-12-15T12:21:13.999131,52.5479316667,13.371889999999999, none, n,0.0060110170073501,19,30,31,6751,2054,358,6,2,2,1919,19,11,1
2020-12-15T12:21:15.017731,52.54790500000001,13.371879999999999, none, n,0.0060110170073501,19,30,31,6751,2054,358,6,2,2,1919,19,11,1
2020-12-15T12:21:16.033104,52.547880000000006,13.3718783333, none, n,0.0060110170073501,19,28,28,6712,1914,338,2,0,0,1919,19,9,0
2020-12-15T12:21:17.048823,52.5478533333,13.371865, none, n,0.0060110170073501,19,28,28,6712,1914,338,2,0,0,1919,19,9,0
2020-12-15T12:21:18.063972,52.547830000000005,13.37185, none, n,0.0060110170073501,21,29,29,6748,1917,336,4,0,0,1919,21,8,0
2020-12-15T12:21:19.085988,52.547805000000004,13.37185, none, n,0.0032066180666629,21,29,29,6748,1917,336,4,0,0,1919,21,8,0
2020-12-15T12:21:20.101047,52.5477866667,13.371846666700002, none, n,0.0032066180666629,21,30,30,6978,2072,343,2,0,0,1919,21,9,0
2020-12-15T12:21:21.123794,52.5477633333,13.371845, none, n,0.0032066180666629,20,29,29,6978,2072,343,2,0,0,1919,20,9,0
2020-12-15T12:21:22.142239,52.54773,13.371845, none, n,0.0032066180666629,20,29,29,6999,2067,346,2,0,0,1919,20,9,0
2020-12-15T12:21:23.159050,52.547709999999995,13.371851666700001, none, n,0.0032066180666629,20,29,29,6999,2067,346,2,0,0,1919,20,9,0
2020-12-15T12:21:24.178680,52.5476683333,13.3718483333, none, n,0.0032066180666629,20,30,30,7172,2089,346,2,0,0,1919,20,10,0
2020-12-15T12:21:25.193454,52.5476283333,13.3718316667, none, n,0.0032066180666629,20,30,30,7172,2089,346,2,0,0,1919,20,10,0
2020-12-15T12:21:26.214364,52.5476166667,13.371825, none, n,0.0032066180666629,20,30,30,7187,2097,341,2,0,0,1919,20,10,0
2020-12-15T12:21:27.231310,52.547601666700004,13.37181, none, n,0.0032530026247034,20,30,30,7187,2097,341,2,0,0,1919,20,10,0
2020-12-15T12:21:28.249147,52.5475716667,13.3717966667, none, n,0.0032530026247034,21,30,32,6975,2079,331,4,2,2,1919,21,9,2
2020-12-15T12:21:29.269914,52.5475466667,13.371785000000001, none, n,0.0032530026247034,21,30,32,6975,2079,331,4,2,2,1919,21,9,2
2020-12-15T12:21:30.295349,52.54752,13.3717783333, none, n,0.0032530026247034,20,29,32,6721,1914,331,6,4,2,1919,20,9,3
2020-12-15T12:21:31.318205,52.5474766667,13.371768333299999, none, n,0.0032530026247034,20,29,32,6721,1914,331,6,4,2,1919,20,9,3
2020-12-15T12:21:32.334968,52.5474516667,13.371766666700001, none, n,0.0032530026247034,20,29,32,6736,1916,323,6,4,2,1919,20,9,3
2020-12-15T12:21:33.350958,52.547430000000006,13.3717816667, none, n,0.0032530026247034,20,29,32,6736,1916,323,6,4,2,1919,20,9,3
2020-12-15T12:21:34.367860,52.547394999999995,13.3717966667, none, n,0.0032530026247034,21,30,33,6960,2074,335,6,4,2,1919,21,9,3
2020-12-15T12:21:35.386003,52.5473683333,13.371804999999998, none, n,0.0037067961161414,20,29,32,6960,2074,335,6,4,2,1919,20,9,3
2020-12-15T12:21:36.401901,52.5473366667,13.371820000000001, none, n,0.0037067961161414,20,30,33,6990,2084,340,6,4,2,1919,20,10,3
2020-12-15T12:21:37.418530,52.5473066667,13.3718216667, none, n,0.0037067961161414,20,30,33,6990,2084,340,6,4,2,1919,20,10,3
2020-12-15T12:21:38.436075,52.5472583333,13.3718233333, none, n,0.0037067961161414,21,30,33,6939,2084,340,4,4,2,1919,21,9,3
2020-12-15T12:21:39.453082,52.547221666700004,13.37183, none, n,0.0037067961161414,21,30,33,6939,2084,340,4,4,2,1919,21,9,3
2020-12-15T12:21:40.471078,52.5471933333,13.371820000000001, none, n,0.0037067961161414,21,31,35,7014,2109,355,8,6,2,1919,21,10,4
2020-12-15T12:21:41.495271,52.547169999999994,13.3717983333, none, n,0.0037067961161414,21,33,36,7038,2116,355,15,6,2,1919,21,12,3
2020-12-15T12:21:42.511203,52.5471533333,13.3717866667, none, n,0.0037067961161414,21,34,38,6969,2097,360,22,6,2,1919,21,13,4
2020-12-15T12:21:43.528237,52.5471433333,13.3717866667, none, n,0.0035784899865275,21,35,38,7038,2124,365,22,6,2,1919,21,14,3
2020-12-15T12:21:44.545309,52.5471183333,13.371795, none, n,0.0035784899865275,22,36,38,7435,2164,380,22,4,0,1919,22,14,2
2020-12-15T12:21:45.548579,52.547088333299996,13.3717966667, none, n,0.0035784899865275,21,36,37,7537,2316,378,20,2,0,1919,21,15,1
2020-12-15T12:21:46.568973,52.547065,13.371803333299999, none, n,0.0035784899865275,21,36,37,7462,2168,378,22,2,0,1919,21,15,1
2020-12-15T12:21:47.585566,52.5470266667,13.371808333299999, none, n,0.0035784899865275,21,36,38,7283,2153,376,26,4,0,1919,21,15,2
2020-12-15T12:21:48.601401,52.547015,13.3718233333, none, n,0.0035784899865275,22,37,40,7435,2163,378,28,6,0,1919,22,15,3
2020-12-15T12:21:49.618012,52.547,13.371861666700001, none, n,0.0035784899865275,22,37,41,7450,2165,373,30,6,0,1919,22,15,4
2020-12-15T12:21:50.635010,52.546975,13.3718766667, none, n,0.0035784899865275,21,37,41,7241,2143,363,30,6,2,1919,21,16,4
2020-12-15T12:21:51.651190,52.54696,13.3718933333, none, ne,0.0030891431402956,21,37,43,7187,2134,373,32,10,4,1919,21,16,6
2020-12-15T12:21:52.667377,52.5469333333,13.371903333299999, none, ne,0.0030891431402956,21,35,41,7023,2129,361,25,10,4,1919,21,14,6
2020-12-15T12:21:53.682465,52.5469116667,13.3719166667, none, ne,0.0030891431402956,20,35,41,6969,2102,361,29,10,4,1919,20,15,6
2020-12-15T12:21:54.697774,52.5468933333,13.371929999999999, none, ne,0.0030891431402956,19,34,40,6685,2060,354,27,10,4,1919,19,15,6
2020-12-15T12:21:55.713207,52.5468733333,13.37195, none, ne,0.0030891431402956,19,34,40,6685,2060,354,27,10,4,1919,19,15,6
2020-12-15T12:21:56.737178,52.5468433333,13.371956666700001, none, ne,0.0030891431402956,19,34,40,6739,2070,359,27,10,4,1919,19,15,6
2020-12-15T12:21:57.758103,52.54683000000001,13.3719733333, none, ne,0.0030891431402956,19,34,40,6739,2070,359,27,10,4,1919,19,15,6
2020-12-15T12:21:58.769325,52.546798333299996,13.3719816667, none, ne,0.0030891431402956,20,34,40,6942,2085,359,25,10,4,1919,20,14,6
2020-12-15T12:21:59.784577,52.5467783333,13.371993333299999, none, ne,0.0030431622116164,20,34,40,6942,2085,359,25,10,4,1919,20,14,6
2020-12-15T12:22:00.804713,52.5467716667,13.372005, none, ne,0.0030431622116164,20,34,39,6999,2105,366,21,8,4,1919,20,14,5
2020-12-15T12:22:01.821949,52.5467433333,13.372003333299999, none, ne,0.0030431622116164,20,34,39,6999,2105,366,21,8,4,1919,20,14,5
2020-12-15T12:22:02.839640,52.5467133333,13.371991666700001, none, ne,0.0030431622116164,20,33,37,6930,2075,364,19,6,4,1919,20,13,4
2020-12-15T12:22:03.856442,52.546685,13.3719883333, none, ne,0.0030431622116164,20,33,37,6930,2075,364,19,6,4,1919,20,13,4
2020-12-15T12:22:04.873904,52.54665,13.3719816667, none, ne,0.0030431622116164,20,33,37,6960,2080,361,17,6,4,1919,20,13,4
2020-12-15T12:22:05.891620,52.54663000000001,13.3719783333, none, ne,0.0030431622116164,20,33,37,6960,2080,361,17,6,4,1919,20,13,4
2020-12-15T12:22:06.906540,52.5466233333,13.3719766667, none, ne,0.0030431622116164,20,31,34,6924,2058,356,13,4,2,1919,20,11,3
2020-12-15T12:22:08.922868,52.5466233333,13.371979999999999, none, n,0.0024655590579208,20,31,34,6924,2058,356,13,4,2,1919,20,11,3
2020-12-15T12:22:09.938431,52.546618333299996,13.3719783333, none, n,0.0024655590579208,21,30,30,6933,2060,341,4,0,0,1919,21,9,0
2020-12-15T12:22:10.953060,52.54662,13.371979999999999, none, n,0.0024655590579208,21,30,30,6933,2060,341,4,0,0,1919,21,9,0
2020-12-15T12:22:11.968951,52.5466466667,13.371996666700001, none, n,0.0024655590579208,21,31,31,6993,2077,356,4,0,0,1919,21,10,0
2020-12-15T12:22:12.983815,52.5466733333,13.3720183333, none, n,0.0024655590579208,21,31,31,6993,2077,356,4,0,0,1919,21,10,0
2020-12-15T12:22:13.999473,52.546661666700004,13.372015, none, n,0.0024655590579208,21,29,29,6739,2049,343,0,0,0,1919,21,8,0
2020-12-15T12:22:15.014251,52.5466066667,13.371985, none, n,0.0024655590579208,21,29,29,6739,2049,343,0,0,0,1919,21,8,0
2020-12-15T12:22:16.035472,52.54655,13.37195, none, n,0.0012003874919135,22,29,29,6993,2076,330,0,0,0,1919,22,7,0
2020-12-15T12:22:17.043763,52.5465116667,13.371929999999999, none, n,0.0012003874919135,22,29,29,6993,2076,330,0,0,0,1919,22,7,0
2020-12-15T12:22:18.066016,52.5465133333,13.3719316667, none, n,0.0012003874919135,22,28,28,6933,2059,322,0,0,0,1919,22,6,0
2020-12-15T12:22:19.091616,52.5465233333,13.3719383333, none, n,0.0012003874919135,22,28,28,6933,2059,322,0,0,0,1919,22,6,0
2020-12-15T12:22:20.116671,52.5465233333,13.3719366667, none, n,0.0012003874919135,22,28,28,6760,1916,320,0,0,0,1919,22,6,0
2020-12-15T12:22:21.129348,52.5465216667,13.3719333333, none, n,0.0012003874919135,22,28,28,6760,1916,320,0,0,0,1919,22,6,0
2020-12-15T12:22:22.155851,52.5465183333,13.3719283333, none, n,0.0012003874919135,21,28,28,6760,1908,310,2,0,0,1919,21,7,0
2020-12-15T12:22:23.178937,52.54651,13.3719283333, none, n,0.0012003874919135,21,28,28,6760,1908,310,2,0,0,1919,21,7,0
2020-12-15T12:22:24.191017,52.546505,13.371925, none, nw,0.0007546232015082401,21,29,29,6933,2048,315,2,0,0,1919,21,8,0
2020-12-15T12:22:25.216284,52.54649499999999,13.371920000000001, none, nw,0.0007546232015082401,21,29,29,6933,2048,315,2,0,0,1919,21,8,0
2020-12-15T12:22:26.232762,52.5464866667,13.371915, none, nw,0.0007546232015082401,21,29,29,6760,1901,318,6,0,0,1919,21,8,0
2020-12-15T12:22:27.249831,52.546481666700004,13.371908333299999, none, nw,0.0007546232015082401,21,29,29,6760,1901,318,6,0,0,1919,21,8,0
2020-12-15T12:22:28.267426,52.5464766667,13.371903333299999, none, nw,0.0007546232015082401,21,31,31,6930,2048,323,8,0,0,1919,21,10,0
2020-12-15T12:22:29.284090,52.5464716667,13.3719, none, nw,0.0007546232015082401,21,31,31,6930,2048,323,8,0,0,1919,21,10,0
2020-12-15T12:22:30.304862,52.546465000000005,13.371898333299999, none, nw,0.0007546232015082401,21,33,33,6960,2058,335,15,0,0,1919,21,12,0
2020-12-15T12:22:31.323976,52.5464583333,13.3719, none, nw,0.0007546232015082401,21,33,33,6960,2058,335,15,0,0,1919,21,12,0
2020-12-15T12:22:32.342942,52.5464533333,13.371901666700001, none, nw,0.00085107441255978,20,31,31,6682,1880,310,15,0,0,1919,20,11,0
2020-12-15T12:22:33.359920,52.546445,13.371903333299999, none, nw,0.00085107441255978,19,32,32,6736,1890,318,19,0,0,1919,19,13,0
2020-12-15T12:22:34.374182,52.546438333299996,13.371908333299999, none, nw,0.00085107441255978,19,32,32,6694,1883,328,19,0,0,1919,19,13,0
2020-12-15T12:22:35.393950,52.546438333299996,13.3719216667, none, nw,0.00085107441255978,19,33,33,6521,1866,333,23,0,0,1919,19,14,0
2020-12-15T12:22:36.408952,52.546434999999995,13.37195, none, nw,0.00085107441255978,18,33,34,6500,1864,338,27,2,0,1919,18,15,1
2020-12-15T12:22:37.430024,52.5464166667,13.371975, none, nw,0.00085107441255978,18,33,34,6455,1847,336,29,2,0,1919,18,15,1
2020-12-15T12:22:38.457578,52.5464166667,13.371993333299999, none, nw,0.00085107441255978,18,33,34,6425,1850,331,33,2,0,1919,18,15,1
2020-12-15T12:22:39.474617,52.54642,13.3720283333, none, nw,0.00085107441255978,18,34,35,6416,1852,353,33,2,0,1919,18,16,1
2020-12-15T12:22:40.493783,52.546415,13.3720583333, none, e,0.0016313003443034,18,34,35,6222,1830,343,35,2,0,1919,18,16,1
2020-12-15T12:22:41.517607,52.54639,13.3720783333, none, e,0.0016313003443034,17,32,33,5929,1655,333,32,2,0,1919,17,15,1
2020-12-15T12:22:43.538615,52.546369999999996,13.372191666700001, none, e,0.0016313003443034,17,33,34,5983,1806,340,34,2,0,1919,17,16,1
2020-12-15T12:22:44.559879,52.5463516667,13.3722233333, none, e,0.0016313003443034,18,32,33,5959,1806,335,30,2,0,1919,18,14,1
2020-12-15T12:22:45.577651,52.5463233333,13.372243333299998, none, e,0.0016313003443034,18,32,33,5756,1655,330,30,2,0,1919,18,14,1
2020-12-15T12:22:46.594728,52.5463033333,13.372266666700002, none, e,0.0016313003443034,18,32,33,5756,1655,330,30,2,0,1919,18,14,1
2020-12-15T12:22:47.614414,52.5462666667,13.372281666700001, none, e,0.0016313003443034,18,31,32,5905,1657,325,26,2,0,1919,18,13,1
2020-12-15T12:22:48.632020,52.546234999999996,13.3723116667, none, ne,0.0037635492184883,18,31,32,5905,1657,325,26,2,0,1919,18,13,1
2020-12-15T12:22:49.649359,52.5462016667,13.3723416667, none, ne,0.0037635492184883,19,31,32,6159,1824,327,24,2,0,1919,19,12,1
2020-12-15T12:22:50.677831,52.5461716667,13.372375, none, ne,0.0037635492184883,19,31,32,6159,1824,327,24,2,0,1919,19,12,1
2020-12-15T12:22:51.695204,52.546130000000005,13.3724066667, none, ne,0.0037635492184883,20,32,33,6416,1869,347,22,2,0,1919,20,12,1
2020-12-15T12:22:52.712527,52.5460916667,13.3724383333, none, ne,0.0037635492184883,20,32,33,6416,1869,347,22,2,0,1919,20,12,1
2020-12-15T12:22:53.732301,52.54605,13.372468333299999, none, ne,0.0037635492184883,20,31,32,6416,1864,344,18,2,0,1919,20,11,1
2020-12-15T12:22:54.749500,52.54600500000001,13.372495, none, ne,0.0037635492184883,21,29,32,6431,1867,327,16,4,2,1919,21,8,3
2020-12-15T12:22:55.766875,52.5459483333,13.37251, none, ne,0.0037635492184883,21,29,33,6497,1882,322,16,6,2,1919,21,8,4
2020-12-15T12:22:56.793073,52.545901666700004,13.3725333333, none, ne,0.0057115964876953,22,31,35,6918,2062,332,16,6,2,1919,22,9,4
2020-12-15T12:22:57.814377,52.5458666667,13.372565, none, ne,0.0057115964876953,22,30,34,6781,2052,337,16,6,2,1919,22,8,4
2020-12-15T12:22:58.830378,52.5458283333,13.372595, none, ne,0.0057115964876953,21,30,34,6948,2055,337,16,6,2,1919,21,9,4
2020-12-15T12:22:59.847838,52.545775,13.372618333299998, none, ne,0.0057115964876953,21,31,35,6999,2070,347,16,6,2,1919,21,10,4
2020-12-15T12:23:00.852898,52.5457266667,13.372645, none, ne,0.0057115964876953,21,33,37,7023,2095,362,16,6,2,1919,21,12,4
2020-12-15T12:23:01.872984,52.5456933333,13.3726866667, none, ne,0.0057115964876953,22,35,39,7187,2113,360,23,6,2,1919,22,13,4
2020-12-15T12:23:02.889740,52.5456583333,13.372725, none, ne,0.0057115964876953,21,34,38,6939,2085,345,25,6,2,1919,21,13,4
2020-12-15T12:23:03.906201,52.54563,13.3727633333, none, ne,0.0057115964876953,20,35,40,6933,2083,360,32,8,2,1919,20,15,5
2020-12-15T12:23:04.924682,52.5455966667,13.3728, none, ne,0.0054871737402037,20,35,39,6987,2090,355,30,6,0,1919,20,15,4
2020-12-15T12:23:05.941998,52.545559999999995,13.3728333333, none, ne,0.0054871737402037,20,36,40,6966,2085,373,33,6,0,1919,20,16,4
2020-12-15T12:23:06.963849,52.545535,13.372875, none, ne,0.0054871737402037,20,36,40,6966,2085,373,33,6,0,1919,20,16,4
2020-12-15T12:23:07.984095,52.5455266667,13.372926666700002, none, ne,0.0054871737402037,19,34,38,6778,2053,363,29,6,0,1919,19,15,4
2020-12-15T12:23:09.004267,52.545515,13.372978333299999, none, ne,0.0054871737402037,19,34,38,6778,2053,363,29,6,0,1919,19,15,4
2020-12-15T12:23:10.021038,52.5455,13.373028333299999, none, ne,0.0054871737402037,19,34,38,6748,2050,363,27,6,0,1919,19,15,4
2020-12-15T12:23:11.041419,52.5454916667,13.373081666700001, none, ne,0.0054871737402037,19,34,38,6748,2050,363,27,6,0,1919,19,15,4
2020-12-15T12:23:12.058478,52.545480000000005,13.373129999999998, none, e,0.0036874183025810002,20,34,37,6733,2052,353,27,6,0,1919,20,14,3
2020-12-15T12:23:13.074552,52.545469999999995,13.37318, none, e,0.0036874183025810002,20,34,37,6733,2052,353,27,6,0,1919,20,14,3
2020-12-15T12:23:14.091006,52.54546,13.373225, none, e,0.0036874183025810002,20,33,37,6742,2052,346,27,6,0,1919,20,13,4
2020-12-15T12:23:15.107800,52.5454366667,13.373261666700001, none, e,0.0036874183025810002,20,33,37,6742,2052,346,27,6,0,1919,20,13,4
2020-12-15T12:23:16.124612,52.5454133333,13.373289999999999, none, e,0.0036874183025810002,20,34,37,6921,2062,359,27,6,0,1919,20,14,3
2020-12-15T12:23:17.140975,52.5453983333,13.373315, none, e,0.0036874183025810002,19,32,35,6509,1887,361,22,6,0,1919,19,13,3
2020-12-15T12:23:18.160192,52.54538,13.3733283333, none, e,0.0036874183025810002,19,32,36,6688,1890,368,22,8,0,1919,19,13,4
2020-12-15T12:23:19.186472,52.545359999999995,13.373353333299999, none, e,0.0036874183025810002,19,32,35,6703,1892,371,19,6,0,1919,19,13,3
2020-12-15T12:23:20.197007,52.54534,13.3733783333, none, ne,0.0032712148679944,19,32,35,6491,1880,373,21,6,0,1919,19,13,3
2020-12-15T12:23:21.222332,52.5453183333,13.373403333299999, none, ne,0.0032712148679944,20,32,34,6700,1912,370,14,4,0,1919,20,12,2
2020-12-15T12:23:22.242874,52.5453066667,13.3735283333, none, ne,0.0032712148679944,20,33,35,6948,2079,378,14,4,0,1919,20,13,2
2020-12-15T12:23:23.259236,52.5453383333,13.373638333299999, none, ne,0.0032712148679944,21,33,35,6963,2082,376,14,4,0,1919,21,12,2
2020-12-15T12:23:24.275352,52.5453733333,13.373676666700002, none, ne,0.0032712148679944,20,34,36,6999,2092,381,16,4,0,1919,20,14,2
2020-12-15T12:23:25.292677,52.5454266667,13.373736666700001, none, ne,0.0032712148679944,21,35,37,7208,2119,516,18,4,0,1919,21,14,2
2020-12-15T12:23:26.309435,52.5454583333,13.373785, none, ne,0.0032712148679944,21,34,37,7029,2106,373,22,4,0,1919,21,13,3
2020-12-15T12:23:27.324461,52.5454683333,13.373831666700001, none, ne,0.0032712148679944,21,35,36,7247,2135,373,18,2,0,1919,21,14,1
2020-12-15T12:23:28.341266,52.54541999999999,13.373871666700001, none, e,0.0049322183560707,21,36,37,7256,2135,378,21,2,0,1919,21,15,1
2020-12-15T12:23:29.358521,52.545375,13.373921666700001, none, e,0.0049322183560707,21,36,37,7256,2135,378,21,2,0,1919,21,15,1
2020-12-15T12:23:30.375097,52.5453283333,13.373961666700001, none, e,0.0049322183560707,21,35,36,7175,2115,375,19,2,0,1919,21,14,1
2020-12-15T12:23:31.392335,52.5453083333,13.3740033333, none, e,0.0049322183560707,21,35,36,7175,2115,375,19,2,0,1919,21,14,1
2020-12-15T12:23:32.410749,52.5453033333,13.37405, none, e,0.0049322183560707,20,34,35,7011,2097,370,17,2,0,1919,20,14,1
2020-12-15T12:23:33.427506,52.5453,13.374104999999998, none, e,0.0049322183560707,20,34,35,7011,2097,370,17,2,0,1919,20,14,1
2020-12-15T12:23:34.451192,52.5452716667,13.3741433333, none, e,0.0049322183560707,20,33,37,6960,2075,370,21,6,4,1919,20,13,4
2020-12-15T12:23:35.466041,52.5452233333,13.3741866667, none, e,0.0049322183560707,20,33,37,6960,2075,370,21,6,4,1919,20,13,4
2020-12-15T12:23:36.485626,52.54515,13.374220000000001, none, ne,0.005451424984918,20,32,36,6712,1915,362,21,6,4,1919,20,12,4
2020-12-15T12:23:37.504032,52.545085,13.374248333299999, none, ne,0.005451424984918,20,32,36,6712,1915,362,21,6,4,1919,20,12,4
2020-12-15T12:23:39.521397,52.544938333299996,13.374325, none, ne,0.005451424984918,20,32,36,6757,1915,359,21,6,4,1919,20,12,4
2020-12-15T12:23:40.547252,52.5449133333,13.374345000000002, none, ne,0.005451424984918,20,32,36,6757,1915,359,21,6,4,1919,20,12,4
2020-12-15T12:23:41.562612,52.5449066667,13.3743616667, none, ne,0.005451424984918,20,32,36,6778,2053,371,19,6,4,1919,20,12,4
2020-12-15T12:23:42.582780,52.5448933333,13.374379999999999, none, ne,0.005451424984918,20,32,36,6778,2053,371,19,6,4,1919,20,12,4
2020-12-15T12:23:43.605590,52.5448916667,13.3744083333, none, ne,0.005451424984918,20,31,37,6739,1913,379,19,8,4,1919,20,11,6
2020-12-15T12:23:44.622973,52.5448866667,13.374429999999998, none, ne,0.0046490016379526,20,31,37,6739,1913,379,19,8,4,1919,20,11,6
2020-12-15T12:23:45.641300,52.5448866667,13.374441666700001, none, ne,0.0046490016379526,20,31,36,6754,1918,374,15,8,4,1919,20,11,5
2020-12-15T12:23:46.666843,52.544895,13.37445, none, ne,0.0046490016379526,20,31,36,6754,1918,374,15,8,4,1919,20,11,5
2020-12-15T12:23:47.680826,52.5448933333,13.37447, none, ne,0.0046490016379526,19,30,35,6521,1874,374,15,8,4,1919,19,11,5
2020-12-15T12:23:48.697717,52.5448666667,13.374488333299999, none, ne,0.0046490016379526,19,30,35,6521,1874,374,15,8,4,1919,19,11,5
2020-12-15T12:23:49.715117,52.5448433333,13.374505, none, ne,0.0046490016379526,19,28,32,6506,1871,359,8,6,4,1919,19,9,4
2020-12-15T12:23:50.732117,52.5448066667,13.3745016667, none, ne,0.0046490016379526,19,28,32,6506,1871,359,8,6,4,1919,19,9,4
2020-12-15T12:23:51.750657,52.544785,13.374479999999998, none, ne,0.0046490016379526,19,28,32,6482,1869,352,10,6,4,1919,19,9,4
2020-12-15T12:23:52.767578,52.5447616667,13.3744566667, none, n,0.0020022489630646,19,28,32,6482,1869,352,10,6,4,1919,19,9,4
2020-12-15T12:23:53.782392,52.54474499999999,13.374436666700001, none, n,0.0020022489630646,19,28,32,6497,1867,352,10,6,4,1919,19,9,4
2020-12-15T12:23:54.802645,52.5447266667,13.374425, none, n,0.0020022489630646,19,28,32,6497,1867,352,10,6,4,1919,19,9,4
2020-12-15T12:23:55.818611,52.544693333299996,13.3744116667, none, n,0.0020022489630646,19,29,30,6685,1882,357,6,2,0,1919,19,10,1
2020-12-15T12:23:56.834331,52.5446716667,13.374396666700001, none, n,0.0020022489630646,19,29,30,6751,1904,357,6,2,0,1919,19,10,1
2020-12-15T12:23:57.849787,52.544646666700004,13.374381666700002, none, n,0.0020022489630646,19,30,32,6760,2049,370,8,4,0,1919,19,11,2
2020-12-15T12:23:58.868427,52.544619999999995,13.3743683333, none, n,0.0020022489630646,19,30,33,6775,1916,370,10,6,2,1919,19,11,3
2020-12-15T12:23:59.880404,52.544575,13.374355, none, n,0.0020022489630646,19,29,33,6927,1919,360,10,6,2,1919,19,10,4
2020-12-15T12:24:00.902774,52.5445333333,13.3743566667, none, nw,0.0037535170496299,18,31,35,6658,1870,362,14,6,2,1919,18,13,4
2020-12-15T12:24:01.911570,52.54452,13.374365, none, nw,0.0037535170496299,19,31,35,6515,1875,352,14,6,2,1919,19,12,4
2020-12-15T12:24:02.935709,52.5445033333,13.374381666700002, none, nw,0.0037535170496299,19,32,36,6515,1880,360,18,6,2,1919,19,13,4
2020-12-15T12:24:03.948582,52.5444933333,13.374405, none, nw,0.0037535170496299,19,32,36,6524,1867,357,21,6,2,1919,19,13,4
2020-12-15T12:24:04.966377,52.5444883333,13.374425, none, nw,0.0037535170496299,19,35,38,6733,1906,377,23,6,2,1919,19,16,3
2020-12-15T12:24:05.982684,52.5444766667,13.374441666700001, none, nw,0.0037535170496299,18,33,37,6479,1866,352,25,6,2,1919,18,15,4
2020-12-15T12:24:06.999127,52.54444,13.374441666700001, none, nw,0.0037535170496299,18,33,38,6434,1842,352,29,8,2,1919,18,15,5
2020-12-15T12:24:08.015344,52.5444216667,13.374436666700001, none, nw,0.0037535170496299,18,33,37,6434,1845,359,29,6,2,1919,18,15,4
2020-12-15T12:24:09.032114,52.5444033333,13.374425, none, ne,0.0021679992270717,18,33,37,6434,1845,359,29,6,2,1919,18,15,4
2020-12-15T12:24:10.050654,52.5443916667,13.3744116667, none, ne,0.0021679992270717,18,33,37,6443,1855,352,31,6,0,1919,18,15,4
2020-12-15T12:24:11.066516,52.5443783333,13.374391666700001, none, ne,0.0021679992270717,18,33,37,6443,1855,352,31,6,0,1919,18,15,4
2020-12-15T12:24:12.084709,52.5443716667,13.3743783333, none, ne,0.0021679992270717,18,33,35,6225,1837,347,29,4,0,1919,18,15,2
2020-12-15T12:24:13.104100,52.5443616667,13.3743566667, none, ne,0.0021679992270717,18,33,35,6225,1837,347,29,4,0,1919,18,15,2
2020-12-15T12:24:14.123710,52.5443466667,13.3743333333, none, ne,0.0021679992270717,18,31,34,6216,1832,332,25,4,0,1919,18,13,3
2020-12-15T12:24:15.138640,52.544325,13.3743133333, none, ne,0.0021679992270717,18,31,34,6216,1832,332,25,4,0,1919,18,13,3
2020-12-15T12:24:16.161965,52.5442983333,13.374295000000002, none, ne,0.0021679992270717,18,31,35,6240,1832,340,27,6,0,1919,18,13,4
2020-12-15T12:24:17.184715,52.544266666700004,13.374275, none, nw,0.0026101482013921,18,31,35,6240,1832,340,27,6,0,1919,18,13,4
2020-12-15T12:24:18.203888,52.5442416667,13.374254999999998, none, nw,0.0026101482013921,17,30,33,6159,1810,330,23,6,0,1919,17,13,3
2020-12-15T12:24:19.219786,52.5442183333,13.3742366667, none, nw,0.0026101482013921,17,30,33,6159,1810,330,23,6,0,1919,17,13,3
2020-12-15T12:24:20.224307,52.5441933333,13.3742183333, none, nw,0.0026101482013921,18,29,33,6231,1840,338,16,6,0,1919,18,11,4
2020-12-15T12:24:21.244009,52.5441666667,13.3742, none, nw,0.0026101482013921,18,29,33,6231,1840,338,16,6,0,1919,18,11,4
2020-12-15T12:24:22.265686,52.5441416667,13.374179999999999, none, nw,0.0026101482013921,18,27,30,5992,1803,313,14,6,0,1919,18,9,3
2020-12-15T12:24:23.282437,52.5441216667,13.374165, none, nw,0.0026101482013921,18,27,30,5992,1803,313,14,6,0,1919,18,9,3
2020-12-15T12:24:24.299729,52.5440966667,13.374161666700001, none, nw,0.0026101482013921,19,29,32,6186,1826,331,16,6,0,1919,19,10,3
2020-12-15T12:24:25.316345,52.5440633333,13.374153333299999, none, nw,0.0034371512132599,19,29,31,6150,1823,344,14,4,0,1919,19,10,2
2020-12-15T12:24:26.333908,52.5440316667,13.374153333299999, none, nw,0.0034371512132599,19,29,32,6207,1837,344,12,4,0,1919,19,10,3
2020-12-15T12:24:27.353224,52.543996666700004,13.3741433333, none, nw,0.0034371512132599,19,28,29,5968,1802,339,8,2,0,1919,19,9,1
2020-12-15T12:24:28.369985,52.543965,13.374139999999999, none, nw,0.0034371512132599,18,27,29,5902,1652,331,8,2,0,1919,18,9,2
2020-12-15T12:24:29.392254,52.5439383333,13.374135, none, nw,0.0034371512132599,18,28,31,5926,1662,339,12,4,2,1919,18,10,3
2020-12-15T12:24:30.416022,52.54391,13.3741333333, none, nw,0.0034371512132599,18,29,30,5926,1654,339,10,2,2,1919,18,11,1
2020-12-15T12:24:31.433591,52.5438816667,13.3741283333, none, nw,0.0034371512132599,18,30,31,5998,1807,349,10,2,2,1919,18,12,1
2020-12-15T12:24:32.451367,52.5438516667,13.374096666700002, none, nw,0.0034371512132599,19,30,32,6225,1839,346,10,2,2,1919,19,11,2
2020-12-15T12:24:33.468820,52.543794999999996,13.374070000000001, none, n,0.0043378433298533,19,33,34,6443,1876,366,12,2,2,1919,19,14,1
2020-12-15T12:24:34.486785,52.5437583333,13.374039999999999, none, n,0.0043378433298533,20,32,34,6434,1883,366,8,2,2,1919,20,12,2
2020-12-15T12:24:35.505062,52.5437183333,13.374015, none, n,0.0043378433298533,20,32,36,6485,1905,363,13,6,2,1919,20,12,4
2020-12-15T12:24:37.524053,52.5435933333,13.3739966667, none, n,0.0043378433298533,19,33,38,6500,1910,366,15,8,4,1919,19,14,5
2020-12-15T12:24:38.540608,52.543571666700004,13.373995, none, n,0.0043378433298533,19,33,38,6500,1910,366,15,8,4,1919,19,14,5
2020-12-15T12:24:39.557747,52.543585,13.374008333299999, none, n,0.0043378433298533,19,34,39,6491,1913,366,19,8,4,1919,19,15,5
2020-12-15T12:24:40.575806,52.543594999999996,13.3740033333, none, n,0.0043378433298533,20,37,44,6924,2098,517,28,10,4,1919,20,17,7
2020-12-15T12:24:41.593781,52.5435966667,13.3740016667, none, n,0.003218955497349001,20,38,42,7169,2135,529,24,8,2,1919,20,18,4
2020-12-15T12:24:42.612579,52.5436116667,13.3739933333, none, n,0.003218955497349001,21,39,44,7256,2163,531,31,8,2,1919,21,18,5
2020-12-15T12:24:43.627712,52.5436233333,13.373970000000002, none, n,0.003218955497349001,20,40,45,7241,2153,553,33,8,2,1919,20,20,5
2020-12-15T12:24:44.652722,52.5436566667,13.373954999999999, none, n,0.003218955497349001,19,39,44,6927,2091,556,37,8,2,1919,19,20,5
2020-12-15T12:24:45.674292,52.543675,13.373925, none, n,0.003218955497349001,19,40,44,6754,2072,551,37,8,2,1919,19,21,4
2020-12-15T12:24:46.691048,52.54371999999999,13.3739033333, none, n,0.003218955497349001,18,40,44,6673,1912,551,41,8,2,1919,18,22,4
2020-12-15T12:24:47.708224,52.5437483333,13.373876666700001, none, n,0.003218955497349001,18,40,42,6682,1908,546,36,4,2,1919,18,22,2
2020-12-15T12:24:48.726092,52.5437733333,13.3738416667, none, n,0.003218955497349001,18,39,40,6691,1911,538,38,2,0,1919,18,21,1
2020-12-15T12:24:49.744696,52.543798333299996,13.3737983333, none, sw,0.003757753401831,18,40,41,6715,1908,550,41,2,0,1919,18,22,1
2020-12-15T12:24:50.760022,52.54382,13.3737516667, none, sw,0.003757753401831,18,38,40,6709,1896,545,36,2,0,1919,18,20,2
2020-12-15T12:24:51.782042,52.54384,13.373705, none, sw,0.003757753401831,17,38,39,6509,1869,538,38,2,0,1919,17,21,1
2020-12-15T12:24:52.803036,52.5438566667,13.373660000000001, none, sw,0.003757753401831,17,38,39,6509,1869,538,38,2,0,1919,17,21,1
2020-12-15T12:24:53.819490,52.543875,13.3736116667, none, sw,0.003757753401831,17,38,39,6676,1886,536,35,2,0,1919,17,21,1
2020-12-15T12:24:54.837246,52.5438916667,13.3735666667, none, sw,0.003757753401831,17,38,39,6676,1886,536,35,2,0,1919,17,21,1
2020-12-15T12:24:55.840087,52.543905,13.3735183333, none, sw,0.003757753401831,18,38,39,6685,1896,516,40,2,0,1919,18,20,1
2020-12-15T12:24:56.863134,52.54391999999999,13.3734733333, none, sw,0.003757753401831,18,38,39,6685,1896,516,40,2,0,1919,18,20,1
2020-12-15T12:24:57.878519,52.5439333333,13.3734283333, none, w,0.0041683371935627,19,37,39,6700,1901,375,38,4,2,1919,19,18,2
2020-12-15T12:24:58.903331,52.5439483333,13.373375, none, w,0.0041683371935627,19,37,40,6745,1918,518,36,4,2,1919,19,18,3
2020-12-15T12:24:59.920868,52.5439633333,13.3733216667, none, w,0.0041683371935627,20,38,42,7172,2103,535,36,4,2,1919,20,18,4
2020-12-15T12:25:00.939118,52.5439783333,13.373270000000002, none, w,0.0041683371935627,21,38,42,7208,2115,535,38,4,2,1919,21,17,4
2020-12-15T12:25:01.955824,52.54399,13.373223333299999, none, w,0.0041683371935627,21,37,40,7026,2102,518,34,4,2,1919,21,16,3
2020-12-15T12:25:02.971455,52.5440033333,13.373178333299998, none, w,0.0041683371935627,21,37,41,7211,2125,526,31,4,2,1919,21,16,4
2020-12-15T12:25:03.986613,52.5440183333,13.373128333299999, none, w,0.0041683371935627,21,36,40,7017,2115,513,29,4,2,1919,21,15,4
2020-12-15T12:25:05.013291,52.5440333333,13.373081666700001, none, w,0.0041683371935627,21,36,39,7023,2120,380,29,4,2,1919,21,15,3
2020-12-15T12:25:06.011353,52.5440516667,13.373036666700001, none, w,0.0042248983071381,21,35,39,6978,2115,375,27,4,2,1919,21,14,4
2020-12-15T12:25:07.033786,52.54407,13.372986666700001, none, w,0.0042248983071381,21,35,38,6984,2107,518,20,4,2,1919,21,14,3
2020-12-15T12:25:08.055621,52.544090000000004,13.372938333299999, none, w,0.0042248983071381,20,35,37,6990,2110,516,20,2,0,1919,20,15,2
2020-12-15T12:25:09.071846,52.5441066667,13.372893333299999, none, w,0.0042248983071381,20,34,37,6939,2088,371,22,4,0,1919,20,14,3
2020-12-15T12:25:10.093882,52.5441216667,13.372841666700001, none, w,0.0042248983071381,20,31,34,6664,1908,344,18,4,0,1919,20,11,3
2020-12-15T12:25:11.110517,52.5441383333,13.372791666700001, none, w,0.0042248983071381,20,31,34,6664,1908,344,18,4,0,1919,20,11,3
2020-12-15T12:25:12.126915,52.5441533333,13.372736666700002, none, w,0.0042248983071381,19,31,33,6464,1888,332,21,4,0,1919,19,12,2
2020-12-15T12:25:13.144765,52.544169999999994,13.3726816667, none, w,0.0039108508230712,19,31,33,6464,1888,332,21,4,0,1919,19,12,2
2020-12-15T12:25:14.166261,52.544185,13.3726283333, none, w,0.0039108508230712,18,31,35,6428,1859,339,23,6,2,1919,18,13,4
2020-12-15T12:25:15.183780,52.544194999999995,13.3725783333, none, w,0.0039108508230712,18,31,35,6428,1859,339,23,6,2,1919,18,13,4
2020-12-15T12:25:16.199914,52.5442066667,13.3725333333, none, w,0.0039108508230712,18,29,33,6249,1846,309,19,6,2,1919,18,11,4
2020-12-15T12:25:17.217265,52.5442083333,13.372489999999999, none, w,0.0039108508230712,18,29,33,6249,1846,309,19,6,2,1919,18,11,4
2020-12-15T12:25:18.236404,52.5442183333,13.37244, none, w,0.0039108508230712,18,29,32,6270,1843,312,17,4,2,1919,18,11,3
2020-12-15T12:25:19.250931,52.5442316667,13.3723883333, none, w,0.0039108508230712,18,29,32,6270,1843,312,17,4,2,1919,18,11,3
2020-12-15T12:25:20.260480,52.5442466667,13.3723383333, none, w,0.0039108508230712,19,31,33,6473,1875,334,15,4,2,1919,19,12,2
2020-12-15T12:25:21.281072,52.5442633333,13.372285, none, w,0.0041087826491972,19,32,36,6524,1880,351,20,6,2,1919,19,13,4
2020-12-15T12:25:22.297239,52.5442783333,13.372228333299999, none, w,0.0041087826491972,19,31,35,6494,1871,329,22,6,2,1919,19,12,4
2020-12-15T12:25:23.313577,52.5442933333,13.3721716667, none, w,0.0041087826491972,20,34,37,6960,2061,346,24,6,2,1919,20,14,3
2020-12-15T12:25:24.331089,52.5443083333,13.3721133333, none, w,0.0041087826491972,21,36,40,7250,2113,371,26,6,2,1919,21,15,4
2020-12-15T12:25:25.347892,52.544325,13.372053333299998, none, w,0.0041087826491972,21,37,40,7510,2162,516,26,6,2,1919,21,16,3
2020-12-15T12:25:26.355401,52.5443366667,13.371998333299999, none, w,0.0041087826491972,21,37,40,7689,2174,526,21,6,2,1919,21,16,3
2020-12-15T12:25:27.378000,52.54435,13.371945000000002, none, w,0.0041087826491972,22,38,40,7800,2354,539,19,4,0,1919,22,16,2
2020-12-15T12:25:28.391221,52.5443633333,13.371891666700002, none, w,0.0041087826491972,23,41,44,8460,2567,561,19,4,0,1919,23,18,3
2020-12-15T12:25:29.412119,52.5443766667,13.3718383333, none, w,0.0046754736814445,24,45,48,8490,2577,573,23,6,2,1919,24,21,3
2020-12-15T12:25:30.433301,52.5443916667,13.371785000000001, none, w,0.0046754736814445,24,44,49,8475,2560,553,27,8,4,1919,24,20,5
2020-12-15T12:25:31.449928,52.544405000000005,13.371735000000001, none, w,0.0046754736814445,24,43,47,8317,2429,541,24,6,4,1919,24,19,4
2020-12-15T12:25:32.466696,52.544415,13.371685000000001, none, w,0.0046754736814445,24,42,47,8469,2562,546,29,8,4,1919,24,18,5
2020-12-15T12:25:33.483376,52.5444266667,13.371633333299998, none, w,0.0046754736814445,24,42,47,8469,2562,546,29,8,4,1919,24,18,5
2020-12-15T12:25:34.500261,52.5444366667,13.371579999999998, none, w,0.0046754736814445,23,41,46,8212,2399,536,25,8,4,1919,23,18,5
2020-12-15T12:25:35.518384,52.544446666700004,13.371528333299999, none, w,0.0046754736814445,23,41,46,8212,2399,536,25,8,4,1919,23,18,5
2020-12-15T12:25:37.536239,52.5444883333,13.3713683333, none, w,0.0048745822581831,23,40,44,7973,2361,526,25,6,4,1919,23,17,4
2020-12-15T12:25:38.537975,52.5445,13.3713216667, none, w,0.0048745822581831,23,40,44,7973,2361,526,25,6,4,1919,23,17,4
2020-12-15T12:25:39.560514,52.544511666700004,13.371286666700001, none, w,0.0048745822581831,23,39,43,7755,2329,381,25,6,4,1919,23,16,4
2020-12-15T12:25:40.578791,52.5445216667,13.371258333299998, none, w,0.0048745822581831,22,37,42,7531,2169,373,23,6,4,1919,22,15,5
2020-12-15T12:25:41.605513,52.54453,13.3712216667, none, w,0.0048745822581831,22,37,41,7486,2156,368,23,6,4,1919,22,15,4
2020-12-15T12:25:42.623248,52.544540000000005,13.371185, none, w,0.0048745822581831,21,35,39,7193,2096,368,23,6,4,1919,21,14,4
2020-12-15T12:25:43.637253,52.544565000000006,13.371156666700001, none, w,0.0048745822581831,21,34,36,7020,2089,351,19,4,2,1919,21,13,2
2020-12-15T12:25:44.657194,52.5445833333,13.3711166667, none, w,0.0048745822581831,20,33,35,6990,2081,359,15,2,0,1919,20,13,2
2020-12-15T12:25:45.671676,52.544630000000005,13.371063333299999, none, sw,0.0037075155427822,22,35,36,7516,2146,374,11,2,0,1919,22,13,1
2020-12-15T12:25:46.688253,52.5447283333,13.3709983333, none, sw,0.0037075155427822,23,36,36,8012,2348,381,4,0,0,1919,23,13,0
2020-12-15T12:25:47.704725,52.5447633333,13.37094, none, sw,0.0037075155427822,24,37,37,8463,2408,514,6,0,0,1919,24,13,0
2020-12-15T12:25:48.722173,52.5447983333,13.370870000000002, none, sw,0.0037075155427822,26,39,39,8741,2591,526,4,0,0,1919,26,13,0
2020-12-15T12:25:49.741992,52.5448083333,13.370818333299999, none, sw,0.0037075155427822,26,39,39,9034,2636,531,6,0,0,1919,26,13,0
2020-12-15T12:25:50.757875,52.5448166667,13.370766666700002, none, sw,0.0037075155427822,28,43,43,9760,2879,549,8,0,0,1919,28,15,0
2020-12-15T12:25:51.779855,52.5448183333,13.370721666700002, none, sw,0.0037075155427822,30,44,44,10053,2932,551,8,0,0,1919,30,14,0
2020-12-15T12:25:52.802816,52.5448183333,13.370679999999998, none, sw,0.0037075155427822,30,44,44,10053,2932,551,8,0,0,1919,30,14,0
2020-12-15T12:25:53.819598,52.5448183333,13.370643333299999, none, sw,0.005041048085299,32,45,48,10265,3087,541,12,4,2,1919,32,13,3
2020-12-15T12:25:54.836122,52.5448166667,13.3706116667, none, sw,0.005041048085299,32,45,48,10265,3087,541,12,4,2,1919,32,13,3
2020-12-15T12:25:55.853814,52.5448166667,13.3705783333, none, sw,0.005041048085299,33,47,50,10588,3139,561,12,4,2,1919,33,14,3
2020-12-15T12:25:56.869305,52.544819999999994,13.370536666700001, none, sw,0.005041048085299,33,47,50,10588,3139,561,12,4,2,1919,33,14,3
2020-12-15T12:25:57.884304,52.544825,13.37049, none, sw,0.005041048085299,34,48,50,10776,3161,576,12,4,2,1919,34,14,2
2020-12-15T12:25:58.900942,52.544828333299996,13.370439999999999, none, sw,0.005041048085299,34,48,50,10776,3161,576,12,4,2,1919,34,14,2
2020-12-15T12:25:59.919721,52.5448333333,13.3703883333, none, sw,0.005041048085299,34,47,50,10567,3151,571,12,4,2,1919,34,13,3
2020-12-15T12:26:00.936419,52.5448383333,13.3703416667, none, sw,0.005041048085299,34,47,50,10567,3151,571,12,4,2,1919,34,13,3
2020-12-15T12:26:01.960448,52.5448466667,13.370296666700002, none, w,0.0033789988340469997,33,46,48,10295,3101,556,12,4,2,1919,33,13,2
2020-12-15T12:26:02.982664,52.5448583333,13.3702483333, none, w,0.0033789988340469997,33,46,48,10295,3101,556,12,4,2,1919,33,13,2
2020-12-15T12:26:04.001978,52.544871666700004,13.3702016667, none, w,0.0033789988340469997,32,44,47,9853,2923,554,10,4,2,1919,32,12,3
2020-12-15T12:26:05.024782,52.5448783333,13.370154999999999, none, w,0.0033789988340469997,32,44,47,9853,2923,554,10,4,2,1919,32,12,3
2020-12-15T12:26:06.040453,52.544871666700004,13.37011, none, w,0.0033789988340469997,30,40,43,9524,2851,517,8,4,2,1919,30,10,3
2020-12-15T12:26:07.056294,52.5448583333,13.370078333299999, none, w,0.0033789988340469997,30,40,43,9524,2851,517,8,4,2,1919,30,10,3
2020-12-15T12:26:08.072234,52.54484,13.3700633333, none, w,0.0033789988340469997,30,40,43,9533,2856,527,6,4,2,1919,30,10,3
2020-12-15T12:26:09.089528,52.5448166667,13.3700416667, none, w,0.0025090409576755,28,38,41,9067,2665,514,6,4,2,1919,28,10,3
2020-12-15T12:26:10.106527,52.5447916667,13.370014999999999, none, w,0.0025090409576755,27,38,41,8783,2610,527,6,4,2,1919,27,11,3
2020-12-15T12:26:11.125424,52.5447666667,13.369986666700001, none, w,0.0025090409576755,26,38,38,8511,2566,535,4,0,0,1919,26,12,0
2020-12-15T12:26:12.142431,52.544738333299996,13.36996, none, w,0.0025090409576755,25,38,38,8224,2388,530,6,0,0,1919,25,13,0
2020-12-15T12:26:13.163135,52.5447033333,13.369929999999998, none, w,0.0025090409576755,24,37,37,8042,2366,512,6,0,0,1919,24,13,0
2020-12-15T12:26:14.179489,52.5446733333,13.3699016667, none, w,0.0025090409576755,22,36,36,7704,2171,381,8,0,0,1919,22,14,0
2020-12-15T12:26:15.195932,52.5446433333,13.3698683333, none, w,0.0025090409576755,22,37,38,7683,2304,527,12,2,2,1919,22,15,1
2020-12-15T12:26:16.212020,52.544601666700004,13.369838333299999, none, w,0.0025090409576755,22,38,41,7719,2306,534,19,4,2,1919,22,16,3
2020-12-15T12:26:17.229222,52.5445633333,13.3698116667, none, nw,0.0045968406797988,21,39,42,7537,2166,546,21,4,2,1919,21,18,3
2020-12-15T12:26:18.244095,52.5445266667,13.3697783333, none, nw,0.0045968406797988,20,39,41,7193,2106,546,23,4,2,1919,20,19,2
2020-12-15T12:26:19.260337,52.5444916667,13.36975, none, nw,0.0045968406797988,19,37,40,6999,2074,541,21,4,2,1919,19,18,3
2020-12-15T12:26:20.275693,52.544455000000006,13.369720000000001, none, nw,0.0045968406797988,20,37,41,7193,2096,523,25,6,2,1919,20,17,4
2020-12-15T12:26:21.292135,52.544415,13.369695000000002, none, nw,0.0045968406797988,21,38,43,7456,2143,525,27,8,4,1919,21,17,5
2020-12-15T12:26:22.309456,52.5443783333,13.369675, none, nw,0.0045968406797988,21,37,43,7465,2153,527,25,8,4,1919,21,16,6
2020-12-15T12:26:23.326805,52.5443366667,13.369660000000001, none, nw,0.0045968406797988,21,37,43,7465,2153,527,25,8,4,1919,21,16,6
2020-12-15T12:26:24.344897,52.5442933333,13.369646666700001, none, nw,0.0045968406797988,22,39,44,7549,2175,537,27,8,4,1919,22,17,5
2020-12-15T12:26:25.350765,52.544245,13.369639999999999, none, nw,0.0053217020203668,22,39,44,7549,2175,537,27,8,4,1919,22,17,5
2020-12-15T12:26:26.372360,52.5441966667,13.3696383333, none, nw,0.0053217020203668,22,39,45,7713,2318,535,27,10,4,1919,22,17,6
2020-12-15T12:26:27.390814,52.54415,13.3696366667, none, nw,0.0053217020203668,22,39,45,7713,2318,535,27,10,4,1919,22,17,6
2020-12-15T12:26:28.408539,52.5441083333,13.3696383333, none, nw,0.0053217020203668,21,37,42,7292,2141,520,25,8,2,1919,21,16,5
2020-12-15T12:26:29.425405,52.544065,13.369641666700002, none, nw,0.0053217020203668,21,37,42,7292,2141,520,25,8,2,1919,21,16,5
2020-12-15T12:26:30.444324,52.5440233333,13.3696383333, none, nw,0.0053217020203668,20,35,39,7435,2146,382,18,6,2,1919,20,15,4
2020-12-15T12:26:31.461145,52.543985,13.3696316667, none, nw,0.0053217020203668,20,35,39,7435,2146,382,18,6,2,1919,20,15,4
2020-12-15T12:26:32.478406,52.5439516667,13.3696183333, none, nw,0.0053217020203668,21,36,41,7698,2313,515,23,8,2,1919,21,15,5
2020-12-15T12:26:33.496306,52.5439283333,13.369596666700001, none, n,0.0050476479174455,21,36,41,7698,2313,515,23,8,2,1919,21,15,5
2020-12-15T12:26:34.513578,52.5439066667,13.3695816667, none, n,0.0050476479174455,23,38,46,7937,2345,512,30,12,4,1919,23,15,8
2020-12-15T12:26:36.530797,52.5438283333,13.369546666700002, none, n,0.0050476479174455,23,38,46,7937,2345,512,30,12,4,1919,23,15,8
2020-12-15T12:26:37.548245,52.543794999999996,13.369556666700001, none, n,0.0050476479174455,24,39,48,8027,2375,525,32,14,4,1919,24,15,9
2020-12-15T12:26:38.565140,52.5437933333,13.369558333299999, none, n,0.0050476479174455,24,39,48,8027,2375,525,32,14,4,1919,24,15,9
2020-12-15T12:26:39.585919,52.5437783333,13.369545, none, n,0.0050476479174455,23,37,45,7743,2331,513,28,12,4,1919,23,14,8
2020-12-15T12:26:40.601645,52.54371999999999,13.369535, none, n,0.0050476479174455,23,37,45,7743,2331,513,28,12,4,1919,23,14,8
2020-12-15T12:26:41.620518,52.543659999999996,13.3695233333, none, n,0.0043209556952075,22,36,42,7510,2175,378,24,10,2,1919,22,14,6
2020-12-15T12:26:42.633699,52.5436116667,13.3695316667, none, n,0.0043209556952075,22,36,42,7510,2175,378,24,10,2,1919,22,14,6
2020-12-15T12:26:43.654531,52.5435466667,13.3695433333, none, n,0.0043209556952075,23,36,42,7689,2320,368,24,10,2,1919,23,13,6
2020-12-15T12:26:44.672340,52.5434966667,13.3695716667, none, n,0.0043209556952075,23,36,42,7689,2320,368,24,10,2,1919,23,13,6
2020-12-15T12:26:45.688599,52.5434533333,13.3695933333, none, n,0.0043209556952075,22,34,40,7262,2155,358,22,10,2,1919,22,12,6
2020-12-15T12:26:46.705530,52.5434033333,13.369613333299998, none, n,0.0043209556952075,22,34,40,7262,2155,358,22,10,2,1919,22,12,6
2020-12-15T12:26:47.722448,52.5433583333,13.3696366667, none, n,0.0043209556952075,22,35,39,7202,2140,348,22,8,2,1919,22,13,4
2020-12-15T12:26:48.739497,52.543315,13.369658333299999, none, n,0.0043209556952075,22,35,39,7202,2140,348,22,8,2,1919,22,13,4
2020-12-15T12:26:49.756003,52.5432683333,13.369679999999999, none, n,0.0064030609316664,23,35,40,7262,2155,350,20,8,2,1919,23,12,5
2020-12-15T12:26:50.772949,52.5432133333,13.369701666700001, none, n,0.0064030609316664,23,35,40,7262,2155,350,20,8,2,1919,23,12,5
2020-12-15T12:26:51.789580,52.543155000000006,13.3697216667, none, n,0.0064030609316664,23,36,41,7429,2170,360,22,8,2,1919,23,13,5
2020-12-15T12:26:52.805993,52.5430966667,13.369745000000002, none, n,0.0064030609316664,23,36,41,7429,2170,360,22,8,2,1919,23,13,5
2020-12-15T12:26:53.832599,52.54303,13.3697666667, none, n,0.0064030609316664,24,36,40,7692,2346,363,17,6,2,1919,24,12,4
2020-12-15T12:26:54.843499,52.542968333299996,13.369793333299999, none, n,0.0064030609316664,24,36,40,7692,2346,363,17,6,2,1919,24,12,4
2020-12-15T12:26:55.863941,52.5429083333,13.369825, none, n,0.0064030609316664,24,36,37,7758,2364,356,8,2,0,1919,24,12,1
2020-12-15T12:26:56.882451,52.542875,13.36984, none, n,0.0064030609316664,24,36,37,7758,2364,356,8,2,0,1919,24,12,1
2020-12-15T12:26:57.904287,52.5428333333,13.3698566667, none, n,0.0071176282102492,24,35,35,7495,2327,346,6,0,0,1919,24,11,0
2020-12-15T12:26:58.920028,52.542784999999995,13.369878333299999, none, n,0.0071176282102492,24,37,38,7704,2351,361,10,2,0,1919,24,13,1
2020-12-15T12:26:59.936172,52.54275,13.369885, none, n,0.0071176282102492,24,36,37,7519,2324,358,10,2,0,1919,24,12,1
2020-12-15T12:27:00.952125,52.54271,13.369891666700001, none, n,0.0071176282102492,23,37,39,7543,2334,376,12,4,0,1919,23,14,2
2020-12-15T12:27:01.968324,52.542676666700004,13.36989, none, n,0.0071176282102492,24,38,41,7716,2349,514,16,4,0,1919,24,14,3
2020-12-15T12:27:02.984082,52.542633333299996,13.3699, none, n,0.0071176282102492,24,39,41,7770,2369,519,16,4,0,1919,24,15,2
2020-12-15T12:27:03.999535,52.5425816667,13.369914999999999, none, n,0.0071176282102492,25,41,43,8018,2403,542,18,4,0,1919,25,16,2
2020-12-15T12:27:05.016262,52.542530000000006,13.369925, none, n,0.0071176282102492,24,40,43,7973,2378,555,16,4,0,1919,24,16,3
2020-12-15T12:27:06.032338,52.5424883333,13.369929999999998, none, n,0.0055259207306682,23,39,42,7746,2338,557,14,4,0,1919,23,16,3
2020-12-15T12:27:07.048686,52.54245,13.369938333299999, none, n,0.0055259207306682,22,39,41,7477,2175,567,16,4,0,1919,22,17,2
2020-12-15T12:27:08.064013,52.542415000000005,13.369943333299998, none, n,0.0055259207306682,22,40,43,7680,2330,577,20,4,0,1919,22,18,3
2020-12-15T12:27:09.079915,52.5423766667,13.3699566667, none, n,0.0055259207306682,21,39,40,7450,2165,569,16,2,0,1919,21,18,1
2020-12-15T12:27:10.096780,52.5423316667,13.369971666700001, none, n,0.0055259207306682,21,40,41,7486,2168,574,18,2,0,1919,21,19,1
2020-12-15T12:27:11.112594,52.5423016667,13.369988333299998, none, n,0.0055259207306682,21,40,41,7486,2168,574,18,2,0,1919,21,19,1
2020-12-15T12:27:12.128476,52.542269999999995,13.37, none, n,0.0055259207306682,21,40,40,7441,2156,561,16,0,0,1919,21,19,0
2020-12-15T12:27:13.143592,52.54224,13.37001, none, n,0.0055259207306682,21,40,40,7441,2156,561,16,0,0,1919,21,19,0
2020-12-15T12:27:14.159840,52.5422116667,13.3700183333, none, n,0.0044769182878423,21,38,38,7513,2304,546,12,0,0,1919,21,17,0
2020-12-15T12:27:15.174991,52.5421716667,13.370033333299999, none, n,0.0044769182878423,21,38,38,7513,2304,546,12,0,0,1919,21,17,0
2020-12-15T12:27:16.190812,52.542134999999995,13.370045000000001, none, n,0.0044769182878423,22,38,38,7761,2329,553,10,0,0,1919,22,16,0
2020-12-15T12:27:17.206144,52.5420983333,13.3700466667, none, n,0.0044769182878423,22,38,38,7761,2329,553,10,0,0,1919,22,16,0
2020-12-15T12:27:18.222273,52.5420633333,13.37005, none, n,0.0044769182878423,22,36,36,7549,2307,533,8,0,0,1919,22,14,0
2020-12-15T12:27:19.238797,52.5420133333,13.370061666700002, none, n,0.0044769182878423,22,36,36,7549,2307,533,8,0,0,1919,22,14,0
2020-12-15T12:27:20.254368,52.54196999999999,13.370071666700001, none, n,0.0044769182878423,21,35,36,7465,2157,380,10,2,0,1919,21,14,1
2020-12-15T12:27:21.272226,52.5419283333,13.370076666700001, none, n,0.0044769182878423,21,35,36,7465,2157,380,10,2,0,1919,21,14,1
2020-12-15T12:27:22.286559,52.5418866667,13.370085000000001, none, n,0.0052026141307772,22,34,35,7435,2159,365,10,2,0,1919,22,12,1
2020-12-15T12:27:23.311683,52.5418483333,13.3700966667, none, n,0.0052026141307772,22,34,35,7435,2159,365,10,2,0,1919,22,12,1
2020-12-15T12:27:24.334495,52.5418083333,13.370113333299999, none, n,0.0052026141307772,22,34,35,7486,2164,350,10,2,0,1919,22,12,1
2020-12-15T12:27:25.352770,52.54178,13.370116666700001, none, n,0.0052026141307772,22,34,35,7486,2164,350,10,2,0,1919,22,12,1
2020-12-15T12:27:26.371747,52.5417666667,13.3700983333, none, n,0.0052026141307772,22,33,34,7486,2149,340,6,2,0,1919,22,11,1
2020-12-15T12:27:27.393614,52.5417316667,13.3700983333, none, n,0.0052026141307772,22,33,34,7486,2149,340,6,2,0,1919,22,11,1
2020-12-15T12:27:28.411688,52.54169,13.3701016667, none, n,0.0052026141307772,22,34,35,7501,2142,350,10,2,0,1919,22,12,1
2020-12-15T12:27:29.428925,52.541646666700004,13.3701083333, none, n,0.0052026141307772,22,34,35,7501,2142,350,10,2,0,1919,22,12,1
2020-12-15T12:27:30.448348,52.54161,13.370113333299999, none, n,0.0044033473391794,22,34,35,7522,2169,353,8,2,0,1919,22,12,1
2020-12-15T12:27:31.463172,52.5415783333,13.3701083333, none, n,0.0044033473391794,22,34,35,7522,2169,353,8,2,0,1919,22,12,1
2020-12-15T12:27:32.470630,52.5415483333,13.3701, none, n,0.0044033473391794,22,33,34,7432,2132,353,8,2,0,1919,22,11,1
2020-12-15T12:27:33.494289,52.5415283333,13.3700883333, none, n,0.0044033473391794,22,33,34,7432,2132,353,8,2,0,1919,22,11,1
2020-12-15T12:27:34.511717,52.5415166667,13.3700633333, none, n,0.0044033473391794,22,34,35,7477,2139,361,10,2,0,1919,22,12,1
2020-12-15T12:27:36.516088,52.541465,13.369975, none, n,0.0044033473391794,22,34,35,7477,2139,361,10,2,0,1919,22,12,1
2020-12-15T12:27:37.535444,52.541446666700004,13.369945000000001, none, n,0.0044033473391794,20,33,34,6990,2074,346,10,2,0,1919,20,13,1
2020-12-15T12:27:38.553762,52.5414316667,13.3699116667, none, nw,0.0034381143154727,20,33,34,6990,2074,346,10,2,0,1919,20,13,1
2020-12-15T12:27:39.571835,52.5414166667,13.369883333299999, none, nw,0.0034381143154727,20,32,35,6969,2064,333,12,4,2,1919,20,12,3
2020-12-15T12:27:40.588367,52.541401666700004,13.369855, none, nw,0.0034381143154727,20,32,35,6969,2064,333,12,4,2,1919,20,12,3
2020-12-15T12:27:41.604963,52.5413883333,13.369826666700002, none, nw,0.0034381143154727,21,32,34,7014,2089,335,10,2,2,1919,21,11,2
2020-12-15T12:27:42.621246,52.541375,13.369798333299999, none, nw,0.0034381143154727,21,32,34,7014,2089,335,10,2,2,1919,21,11,2
2020-12-15T12:27:43.642527,52.5413616667,13.36977, none, nw,0.0034381143154727,21,32,34,6978,2069,335,10,2,2,1919,21,11,2
2020-12-15T12:27:44.659437,52.5413466667,13.369743333299999, none, nw,0.0034381143154727,21,32,34,6978,2069,335,10,2,2,1919,21,11,2
2020-12-15T12:27:45.676064,52.5413316667,13.369715, none, nw,0.0034381143154727,20,31,32,6724,1901,325,8,2,2,1919,20,11,1
2020-12-15T12:27:46.692852,52.5413183333,13.3696816667, none, n,0.0028597886785309,20,31,32,6724,1901,325,8,2,2,1919,20,11,1
2020-12-15T12:27:47.711396,52.5413033333,13.369654999999998, none, n,0.0028597886785309,19,30,33,6506,1881,335,10,4,4,1919,19,11,3
2020-12-15T12:27:48.714274,52.541290000000004,13.3696283333, none, n,0.0028597886785309,19,30,33,6506,1881,335,10,4,4,1919,19,11,3
2020-12-15T12:27:49.740529,52.5412783333,13.369604999999998, none, n,0.0028597886785309,20,30,33,6730,1915,330,6,4,4,1919,20,10,3
2020-12-15T12:27:50.768269,52.541266666700004,13.3695833333, none, n,0.0028597886785309,20,30,33,6730,1915,330,6,4,4,1919,20,10,3
2020-12-15T12:27:51.785183,52.5412566667,13.36956, none, n,0.0028597886785309,20,30,35,6739,1910,340,13,6,4,1919,20,10,5
2020-12-15T12:27:52.803304,52.541244999999996,13.3695383333, none, n,0.0028597886785309,20,30,35,6739,1910,340,13,6,4,1919,20,10,5
2020-12-15T12:27:53.825509,52.541230000000006,13.369518333299999, none, n,0.0028597886785309,22,32,39,6987,2082,360,17,10,6,1919,22,10,7
2020-12-15T12:27:54.844048,52.5412166667,13.369489999999999, none, nw,0.0024570024094557,22,32,39,6987,2082,360,17,10,6,1919,22,10,7
2020-12-15T12:27:55.859994,52.5412033333,13.369458333299999, none, nw,0.0024570024094557,21,32,39,6942,2058,362,19,10,6,1919,21,11,7
2020-12-15T12:27:56.876134,52.5411866667,13.369428333299998, none, nw,0.0024570024094557,21,32,39,6942,2058,362,19,10,6,1919,21,11,7
2020-12-15T12:27:57.892699,52.5411683333,13.3693966667, none, nw,0.0024570024094557,22,32,39,6978,2066,365,19,10,6,1919,22,10,7
2020-12-15T12:27:58.909662,52.5411483333,13.369363333299999, none, nw,0.0024570024094557,22,32,39,6978,2066,365,19,10,6,1919,22,10,7
2020-12-15T12:27:59.927707,52.5411283333,13.36933, none, nw,0.0024570024094557,22,33,39,7023,2083,365,19,8,4,1919,22,11,6
2020-12-15T12:28:00.944135,52.5411066667,13.3692983333, none, nw,0.0024570024094557,22,33,39,7023,2083,365,19,8,4,1919,22,11,6
2020-12-15T12:28:01.963853,52.5410833333,13.369270000000002, none, nw,0.0024570024094557,21,32,38,6921,2048,360,19,8,4,1919,21,11,6
2020-12-15T12:28:02.982774,52.541075,13.3692033333, none, n,0.0035685303083547,21,32,38,6921,2048,360,19,8,4,1919,21,11,6
2020-12-15T12:28:04.002819,52.5410616667,13.3691466667, none, n,0.0035685303083547,21,32,37,6742,1903,358,19,8,4,1919,21,11,5
2020-12-15T12:28:05.019938,52.541045,13.369091666700001, none, n,0.0035685303083547,21,32,37,6742,1903,358,19,8,4,1919,21,11,5
2020-12-15T12:28:06.035833,52.5410266667,13.369036666700001, none, n,0.0035685303083547,21,34,39,6772,1916,383,23,8,4,1919,21,13,5
2020-12-15T12:28:07.052065,52.5410083333,13.368979999999999, none, n,0.0035685303083547,21,34,39,6772,1916,383,23,8,4,1919,21,13,5
2020-12-15T12:28:08.068147,52.5409883333,13.3689233333, none, n,0.0035685303083547,21,35,39,6981,2071,526,21,6,2,1919,21,14,4
2020-12-15T12:28:09.084174,52.5409733333,13.36886, none, n,0.0035685303083547,21,35,39,6981,2071,526,21,6,2,1919,21,14,4
2020-12-15T12:28:10.101370,52.5409566667,13.3687916667, none, w,0.004399021900906,22,36,40,7175,2094,516,23,8,2,1919,22,14,4
2020-12-15T12:28:11.117450,52.5409383333,13.368725, none, w,0.004399021900906,22,36,40,7175,2094,516,23,8,2,1919,22,14,4
2020-12-15T12:28:12.133521,52.5409183333,13.368654999999999, none, w,0.004399021900906,21,35,38,7175,2089,375,18,6,2,1919,21,14,3
2020-12-15T12:28:13.151597,52.54089499999999,13.3685916667, none, w,0.004399021900906,21,35,38,7175,2089,375,18,6,2,1919,21,14,3
2020-12-15T12:28:14.165990,52.5408716667,13.368528333299999, none, w,0.004399021900906,20,34,35,6936,2050,353,16,2,0,1919,20,14,1
2020-12-15T12:28:15.187769,52.5408483333,13.36846, none, w,0.004399021900906,20,34,35,6936,2050,353,16,2,0,1919,20,14,1
2020-12-15T12:28:16.202538,52.5408283333,13.36839, none, w,0.004399021900906,21,34,35,6936,2069,361,12,2,0,1919,21,13,1
2020-12-15T12:28:17.217866,52.540805000000006,13.368325, none, w,0.004399021900906,21,34,35,6936,2069,361,12,2,0,1919,21,13,1
2020-12-15T12:28:18.233263,52.540780000000005,13.3682633333, none, w,0.0058249073271593,22,36,37,7220,2123,371,14,2,0,1919,22,14,1
2020-12-15T12:28:19.248971,52.540755000000004,13.368205, none, w,0.0058249073271593,22,36,37,7220,2123,371,14,2,0,1919,22,14,1
2020-12-15T12:28:20.252578,52.5407316667,13.368141666700001, none, w,0.0058249073271593,21,35,36,7032,2113,381,12,2,0,1919,21,14,1
2020-12-15T12:28:21.272356,52.540708333299996,13.368085, none, w,0.0058249073271593,21,35,36,7032,2113,381,12,2,0,1919,21,14,1
2020-12-15T12:28:22.292568,52.5406733333,13.3680166667, none, w,0.0058249073271593,22,36,37,7226,2136,514,12,2,0,1919,22,14,1
2020-12-15T12:28:23.309661,52.5406333333,13.3679383333, none, w,0.0058249073271593,22,36,37,7226,2136,514,12,2,0,1919,22,14,1
2020-12-15T12:28:24.333391,52.5405916667,13.367870000000002, none, w,0.0058249073271593,23,37,39,7501,2316,521,14,4,0,1919,23,14,2
2020-12-15T12:28:25.350690,52.54054,13.3678, none, w,0.0058249073271593,23,37,39,7501,2316,521,14,4,0,1919,23,14,2
2020-12-15T12:28:26.373932,52.5404916667,13.367738333299998, none, nw,0.0068340766089329,24,36,39,7689,2333,518,10,4,0,1919,24,12,3
2020-12-15T12:28:27.390943,52.540455,13.367723333299999, none, nw,0.0068340766089329,24,36,39,7689,2333,518,10,4,0,1919,24,12,3
2020-12-15T12:28:28.408015,52.540385,13.36774, none, nw,0.0068340766089329,24,36,38,7758,2358,372,10,4,0,1919,24,12,2
2020-12-15T12:28:29.425153,52.54031,13.36776, none, nw,0.0068340766089329,24,36,38,7758,2358,372,10,4,0,1919,24,12,2
2020-12-15T12:28:30.442067,52.54025,13.3677583333, none, nw,0.0068340766089329,24,37,38,7767,2370,530,8,2,0,1919,24,13,1
2020-12-15T12:28:31.460110,52.5402066667,13.367731666700001, none, nw,0.0068340766089329,24,37,38,7767,2370,530,8,2,0,1919,24,13,1
2020-12-15T12:28:32.483442,52.5401633333,13.3677, none, nw,0.0068340766089329,25,37,38,7976,2395,525,6,2,0,1919,25,12,1
2020-12-15T12:28:33.500282,52.5401066667,13.36769, none, nw,0.0068340766089329,25,37,38,7976,2395,525,6,2,0,1919,25,12,1
2020-12-15T12:28:34.517473,52.5400433333,13.367688333299999, none, n,0.0071381429383384,26,39,40,8221,2567,550,6,2,0,1919,26,13,1
2020-12-15T12:28:36.533693,52.53983,13.367729999999998, none, n,0.0071381429383384,26,38,39,8221,2560,535,10,2,0,1919,26,12,1
2020-12-15T12:28:37.551812,52.5397783333,13.3677133333, none, n,0.0071381429383384,25,37,38,8012,2397,532,8,2,0,1919,25,12,1
2020-12-15T12:28:38.569039,52.539730000000006,13.3676916667, none, n,0.0071381429383384,26,39,40,8281,2568,540,10,2,0,1919,26,13,1
2020-12-15T12:28:39.591197,52.539685,13.3676666667, none, n,0.0071381429383384,26,41,42,8490,2590,555,12,2,0,1919,26,15,1
2020-12-15T12:28:40.602050,52.53964499999999,13.367638333299999, none, n,0.0071381429383384,26,42,43,8565,2600,580,14,2,0,1919,26,16,1
2020-12-15T12:28:41.623635,52.5396033333,13.3676133333, none, n,0.0071381429383384,27,43,47,8798,2635,583,21,6,2,1919,27,16,4
2020-12-15T12:28:42.641625,52.5395616667,13.36759, none, n,0.0077100159346048,28,45,49,9037,2665,608,21,6,2,1919,28,17,4
2020-12-15T12:28:43.658384,52.539519999999996,13.3675616667, none, n,0.0077100159346048,28,45,49,9037,2663,591,21,6,2,1919,28,17,4
2020-12-15T12:28:44.676055,52.5394833333,13.367531666700001, none, n,0.0077100159346048,29,47,51,9482,2843,609,23,6,2,1919,29,18,4
2020-12-15T12:28:45.690875,52.5394483333,13.367491666700001, none, n,0.0077100159346048,29,48,51,9482,2838,599,25,6,2,1919,29,19,3
2020-12-15T12:28:46.712466,52.539415000000005,13.367451666700001, none, n,0.0077100159346048,28,48,52,9318,2833,609,25,6,2,1919,28,20,4
2020-12-15T12:28:47.728529,52.539386666700004,13.3674066667, none, n,0.0077100159346048,28,49,54,9333,2838,624,27,8,4,1919,28,21,5
2020-12-15T12:28:48.745256,52.5393566667,13.367363333299998, none, n,0.0077100159346048,28,49,54,9333,2838,624,27,8,4,1919,28,21,5
2020-12-15T12:28:49.761880,52.5393383333,13.36731, none, n,0.0077100159346048,27,47,52,9267,2682,614,27,8,4,1919,27,20,5
2020-12-15T12:28:50.778762,52.539315,13.367263333299999, none, nw,0.0050312783376584,27,47,52,9267,2682,614,27,8,4,1919,27,20,5
2020-12-15T12:28:51.795241,52.539280000000005,13.367213333299999, none, nw,0.0050312783376584,27,45,50,9079,2660,589,25,8,4,1919,27,18,5
2020-12-15T12:28:52.811441,52.5392483333,13.367165, none, nw,0.0050312783376584,27,45,50,9079,2660,589,25,8,4,1919,27,18,5
2020-12-15T12:28:53.826935,52.5392183333,13.367120000000002, none, nw,0.0050312783376584,26,44,48,8825,2635,562,23,6,4,1919,26,18,4
2020-12-15T12:28:54.843558,52.5391866667,13.367075, none, nw,0.0050312783376584,26,44,48,8825,2635,562,23,6,4,1919,26,18,4
2020-12-15T12:28:55.860115,52.5391583333,13.367029999999998, none, nw,0.0050312783376584,25,42,44,8756,2610,552,16,2,2,1919,25,17,2
2020-12-15T12:28:56.878423,52.53913000000001,13.366983333299999, none, nw,0.0050312783376584,25,42,44,8756,2610,552,16,2,2,1919,25,17,2
2020-12-15T12:28:57.891535,52.5391033333,13.366935, none, nw,0.0050312783376584,25,40,43,8532,2575,527,18,4,2,1919,25,15,3
2020-12-15T12:28:58.908347,52.5390783333,13.366881666700001, none, nw,0.0052660238827896,25,40,43,8532,2575,527,18,4,2,1919,25,15,3
2020-12-15T12:28:59.925251,52.5390666667,13.3668116667, none, nw,0.0052660238827896,24,41,43,8472,2422,532,22,4,2,1919,24,17,2
2020-12-15T12:29:00.941341,52.539065,13.3667283333, none, nw,0.0052660238827896,24,41,43,8472,2422,532,22,4,2,1919,24,17,2
2020-12-15T12:29:01.958905,52.539051666700004,13.3666616667, none, nw,0.0052660238827896,22,37,40,7767,2330,381,20,4,2,1919,22,15,3
2020-12-15T12:29:02.977387,52.53904,13.366593333299999, none, nw,0.0052660238827896,22,36,41,7752,2328,378,23,8,2,1919,22,14,5
2020-12-15T12:29:03.989815,52.5390266667,13.366535, none, nw,0.0052660238827896,23,36,41,7961,2355,383,19,8,2,1919,23,13,5
2020-12-15T12:29:05.006680,52.5390166667,13.3664733333, none, nw,0.0052660238827896,23,36,40,7764,2343,368,19,8,0,1919,23,13,4
2020-12-15T12:29:06.022546,52.539015,13.3664, none, nw,0.0052660238827896,23,37,41,7749,2338,378,17,8,0,1919,23,14,4
2020-12-15T12:29:07.038681,52.539015,13.366323333299999, none, w,0.0054874083787714,23,37,41,7743,2335,516,19,8,0,1919,23,14,4
2020-12-15T12:29:08.054920,52.539030000000004,13.366221666700001, none, w,0.0054874083787714,23,37,42,7779,2345,521,17,8,0,1919,23,14,5
2020-12-15T12:29:09.071405,52.5390133333,13.3661683333, none, w,0.0054874083787714,24,40,44,7803,2365,536,21,8,0,1919,24,16,4
2020-12-15T12:29:10.088969,52.53899499999999,13.36612, none, w,0.0054874083787714,23,37,42,7534,2326,526,21,8,0,1919,23,14,5
2020-12-15T12:29:11.104673,52.53898,13.3660666667, none, w,0.0054874083787714,24,36,41,7519,2331,516,19,8,0,1919,24,12,5
2020-12-15T12:29:12.121406,52.538961666700004,13.36602, none, w,0.0054874083787714,24,38,42,7734,2368,524,21,8,0,1919,24,14,4
2020-12-15T12:29:13.142892,52.5389566667,13.3659583333, none, w,0.0054874083787714,25,37,39,7764,2370,512,14,4,0,1919,25,12,2
2020-12-15T12:29:14.157635,52.5389833333,13.365870000000001, none, w,0.0054874083787714,24,37,39,7540,2331,366,18,4,0,1919,24,13,2
2020-12-15T12:29:15.172926,52.5390116667,13.3657733333, none, w,0.0053141446845066,24,37,39,7540,2331,366,18,4,0,1919,24,13,2
2020-12-15T12:29:16.191485,52.5390316667,13.365685000000001, none, w,0.0053141446845066,25,37,38,7797,2366,364,16,2,0,1919,25,12,1
2020-12-15T12:29:17.207787,52.539035,13.365613333299999, none, w,0.0053141446845066,25,37,38,7797,2366,364,16,2,0,1919,25,12,1
2020-12-15T12:29:18.223487,52.5390333333,13.36555, none, w,0.0053141446845066,26,37,38,7991,2394,369,16,2,0,1919,26,11,1
2020-12-15T12:29:19.240884,52.5390233333,13.36549, none, w,0.0053141446845066,26,37,38,7991,2394,369,16,2,0,1919,26,11,1
2020-12-15T12:29:20.261457,52.539019999999994,13.365428333299999, none, w,0.0053141446845066,26,37,40,8027,2399,369,18,4,0,1919,26,11,3
2020-12-15T12:29:21.281091,52.5390133333,13.365371666700002, none, w,0.0053141446845066,26,37,40,8027,2399,369,18,4,0,1919,26,11,3
2020-12-15T12:29:22.295693,52.5390016667,13.3653166667, none, w,0.0053141446845066,25,37,39,7967,2379,371,18,4,0,1919,25,12,2
2020-12-15T12:29:23.313764,52.538990000000005,13.365241666700001, none, w,0.0051482741833256,25,37,39,7967,2379,371,18,4,0,1919,25,12,2
2020-12-15T12:29:24.333818,52.53896999999999,13.365181666700002, none, w,0.0051482741833256,25,35,37,7794,2349,341,14,4,0,1919,25,10,2
2020-12-15T12:29:25.350732,52.5389566667,13.365089999999999, none, w,0.0051482741833256,25,35,37,7794,2349,341,14,4,0,1919,25,10,2
2020-12-15T12:29:26.369082,52.5389416667,13.365008333299999, none, w,0.0051482741833256,25,36,38,7994,2373,354,14,4,0,1919,25,11,2
2020-12-15T12:29:27.384031,52.5389266667,13.3649416667, none, w,0.0051482741833256,25,36,38,7994,2373,354,14,4,0,1919,25,11,2
2020-12-15T12:29:28.401105,52.538918333299996,13.364868333299999, none, w,0.0051482741833256,25,35,37,8030,2370,346,14,4,0,1919,25,10,2
2020-12-15T12:29:29.418367,52.5389066667,13.3647983333, none, w,0.0051482741833256,25,35,37,8030,2370,346,14,4,0,1919,25,10,2
2020-12-15T12:29:30.434837,52.53889,13.364735000000001, none, w,0.0051482741833256,25,34,37,7970,2346,351,14,6,0,1919,25,9,3
2020-12-15T12:29:31.452001,52.5388766667,13.3646633333, none, w,0.005870499703618,25,34,37,7970,2346,351,14,6,0,1919,25,9,3
2020-12-15T12:29:32.469043,52.5388633333,13.3645916667, none, w,0.005870499703618,24,33,36,7716,2312,346,14,6,0,1919,24,9,3
2020-12-15T12:29:33.485698,52.538844999999995,13.364538333299999, none, w,0.005870499703618,24,33,36,7716,2312,346,14,6,0,1919,24,9,3
2020-12-15T12:29:34.503171,52.5388233333,13.364498333299998, none, w,0.005870499703618,24,33,37,7752,2324,354,12,8,0,1919,24,9,4
2020-12-15T12:29:35.519513,52.5388016667,13.3644616667, none, w,0.005870499703618,24,33,37,7752,2324,354,12,8,0,1919,24,9,4
2020-12-15T12:29:37.538031,52.5387433333,13.3643633333, none, w,0.005870499703618,22,30,36,7226,2111,346,14,10,0,1919,22,8,6
2020-12-15T12:29:38.556402,52.538725,13.3643283333, none, w,0.005870499703618,22,30,36,7226,2111,346,14,10,0,1919,22,8,6
2020-12-15T12:29:39.570906,52.5387033333,13.3642933333, none, n,0.0045122350886919,20,29,35,6739,1903,323,18,12,0,1919,20,9,6
2020-12-15T12:29:40.596392,52.5386816667,13.364254999999998, none, n,0.0045122350886919,20,29,35,6739,1903,323,18,12,0,1919,20,9,6
2020-12-15T12:29:41.612453,52.5386583333,13.364215, none, n,0.0045122350886919,20,27,33,6449,1871,321,14,10,0,1919,20,7,6
2020-12-15T12:29:42.634926,52.5386366667,13.364175, none, n,0.0045122350886919,20,27,33,6449,1871,321,14,10,0,1919,20,7,6
2020-12-15T12:29:43.652236,52.5386133333,13.3641433333, none, n,0.0045122350886919,19,26,32,6180,1829,316,14,10,0,1919,19,7,6
2020-12-15T12:29:44.670711,52.5385883333,13.36411, none, n,0.0045122350886919,19,26,32,6180,1829,316,14,10,0,1919,19,7,6
2020-12-15T12:29:45.688955,52.5385666667,13.364078333299998, none, n,0.0045122350886919,18,28,34,6186,1839,346,18,10,0,1919,18,10,6
2020-12-15T12:29:46.703162,52.5385433333,13.3640483333, none, n,0.0045122350886919,19,31,35,6255,1864,363,23,8,0,1919,19,12,4
2020-12-15T12:29:47.721156,52.5385183333,13.364018333299999, none, nw,0.0039617369875762,18,31,36,5956,1825,373,23,8,0,1919,18,13,5
2020-12-15T12:29:48.737754,52.538495,13.363983333299998, none, nw,0.0039617369875762,17,31,34,5756,1800,363,23,6,0,1919,17,14,3
2020-12-15T12:29:49.758261,52.5384716667,13.3639483333, none, nw,0.0039617369875762,17,31,34,5735,1654,358,25,6,0,1919,17,14,3
2020-12-15T12:29:50.774903,52.53845,13.3639116667, none, nw,0.0039617369875762,16,31,34,5714,1649,348,25,6,0,1919,16,15,3
2020-12-15T12:29:51.791688,52.538430000000005,13.363875, none, nw,0.0039617369875762,17,33,35,6156,1837,358,25,4,0,1919,17,16,2
2020-12-15T12:29:52.809216,52.53841,13.363836666700001, none, nw,0.0039617369875762,19,34,35,6449,1887,368,21,2,0,1919,19,15,1
2020-12-15T12:29:53.823927,52.5383883333,13.363805, none, nw,0.0039617369875762,19,36,39,6667,1907,373,25,4,0,1919,19,17,3
2020-12-15T12:29:54.844163,52.5383683333,13.363775, none, nw,0.0039617369875762,19,36,40,6667,1910,373,29,6,0,1919,19,17,4
2020-12-15T12:29:55.861159,52.5383466667,13.3637533333, none, nw,0.0037405087647169,20,35,38,6706,2053,358,25,6,0,1919,20,15,3
2020-12-15T12:29:56.877140,52.5383333333,13.3637, none, nw,0.0037405087647169,19,33,36,6518,1893,346,20,6,0,1919,19,14,3
2020-12-15T12:29:57.892616,52.538325,13.36364, none, nw,0.0037405087647169,19,32,36,6751,1913,341,18,6,0,1919,19,13,4
2020-12-15T12:29:58.910216,52.5383166667,13.363591666700001, none, nw,0.0037405087647169,19,32,36,6751,1913,341,18,6,0,1919,19,13,4
2020-12-15T12:29:59.925825,52.5383083333,13.363546666700001, none, nw,0.0037405087647169,20,34,37,6951,2061,351,16,6,0,1919,20,14,3
2020-12-15T12:30:00.943257,52.5383033333,13.3635, none, nw,0.0037405087647169,20,34,37,6951,2061,351,16,6,0,1919,20,14,3
2020-12-15T12:30:01.957794,52.5383,13.36346, none, nw,0.0037405087647169,20,35,38,7017,2093,371,14,6,0,1919,20,15,3
2020-12-15T12:30:02.973609,52.538295,13.3634283333, none, nw,0.0037405087647169,20,34,37,7017,2093,371,14,6,0,1919,20,14,3
2020-12-15T12:30:03.989699,52.53829,13.3633983333, none, w,0.0035460641413548,20,36,40,7190,2105,526,19,4,0,1919,20,16,4
2020-12-15T12:30:05.008558,52.5382933333,13.363358333299999, none, w,0.0035460641413548,20,36,40,7190,2105,526,19,4,0,1919,20,16,4
2020-12-15T12:30:06.023338,52.538325,13.363313333299999, none, w,0.0035460641413548,19,36,39,6981,2080,521,19,4,0,1919,19,17,3
2020-12-15T12:30:07.045000,52.5383516667,13.363275, none, w,0.0035460641413548,19,37,39,6927,2068,521,26,4,0,1919,19,18,2
2020-12-15T12:30:08.063342,52.5383816667,13.3632366667, none, w,0.0035460641413548,19,38,39,6999,2100,546,26,2,0,1919,19,19,1
2020-12-15T12:30:09.079555,52.53841,13.3632016667, none, w,0.0035460641413548,20,40,40,7277,2137,546,29,0,0,1919,20,20,0
2020-12-15T12:30:10.097207,52.538430000000005,13.363170000000002, none, w,0.0035460641413548,19,40,41,7038,2107,556,33,2,0,1919,19,21,1
2020-12-15T12:30:11.114503,52.5384416667,13.363133333299999, none, sw,0.0035156418046201,19,41,43,6993,2105,563,40,4,0,1919,19,22,2
2020-12-15T12:30:12.132943,52.53845,13.3630916667, none, sw,0.0035156418046201,20,42,44,6993,2110,571,47,4,0,1919,20,22,2
2020-12-15T12:30:13.147193,52.5384433333,13.36306, none, sw,0.0035156418046201,20,42,45,7038,2119,573,47,4,0,1919,20,22,3
2020-12-15T12:30:14.171756,52.5384333333,13.363035, none, sw,0.0035156418046201,20,42,45,7023,2119,563,49,6,0,1919,20,22,3
2020-12-15T12:30:15.194530,52.5384183333,13.3630166667, none, sw,0.0035156418046201,21,40,43,6963,2107,543,42,6,0,1919,21,19,3
2020-12-15T12:30:16.210924,52.5384,13.3630066667, none, sw,0.0035156418046201,21,39,43,6769,2087,541,40,6,0,1919,21,18,4
2020-12-15T12:30:17.230360,52.5383783333,13.362991666700001, none, sw,0.0035156418046201,21,39,42,6912,2089,546,33,6,0,1919,21,18,3
2020-12-15T12:30:18.243933,52.538355,13.362983333299999, none, sw,0.0035156418046201,20,39,42,6754,2064,526,36,6,0,1919,20,19,3
2020-12-15T12:30:19.263766,52.538325,13.362964999999999, none, nw,0.0024656336576715,20,39,42,6754,2064,526,36,6,0,1919,20,19,3
2020-12-15T12:30:20.280011,52.5383066667,13.36295, none, nw,0.0024656336576715,20,37,41,6709,2049,524,29,6,0,1919,20,17,4
2020-12-15T12:30:21.296453,52.5382916667,13.3629533333, none, nw,0.0024656336576715,21,38,40,7023,2096,516,25,4,0,1919,21,17,2
2020-12-15T12:30:22.312791,52.5382716667,13.36295, none, nw,0.0024656336576715,22,37,38,7211,2110,363,18,2,0,1919,22,15,1
2020-12-15T12:30:23.329035,52.5382366667,13.362946666700001, none, nw,0.0024656336576715,21,36,37,7277,2134,365,13,2,0,1919,21,15,1
2020-12-15T12:30:24.345994,52.53821,13.3629533333, none, nw,0.0024656336576715,22,36,38,7256,2139,358,17,2,0,1919,22,14,2
2020-12-15T12:30:25.363035,52.538178333299996,13.3629583333, none, nw,0.0024656336576715,21,35,35,7032,2110,345,15,0,0,1919,21,14,0
2020-12-15T12:30:26.381438,52.5381466667,13.3629566667, none, nw,0.0024656336576715,21,38,38,7271,2132,355,24,0,0,1919,21,17,0
2020-12-15T12:30:27.399382,52.5381216667,13.3629516667, none, n,0.003232526340447,22,39,39,7516,2172,365,26,0,0,1919,22,17,0
2020-12-15T12:30:28.418357,52.5381016667,13.362935, none, n,0.003232526340447,22,40,40,7689,2307,363,30,0,0,1919,22,18,0
2020-12-15T12:30:29.444898,52.5380816667,13.36292, none, n,0.003232526340447,23,39,39,7728,2314,355,25,0,0,1919,23,16,0
2020-12-15T12:30:30.461729,52.5380616667,13.362910000000001, none, n,0.003232526340447,22,39,39,7534,2171,347,27,0,0,1919,22,17,0
2020-12-15T12:30:31.478951,52.538045,13.3629116667, none, n,0.003232526340447,21,37,37,7008,2097,342,29,0,0,1919,21,16,0
2020-12-15T12:30:32.496015,52.5380316667,13.362929999999999, none, n,0.003232526340447,20,36,36,6715,2050,340,27,0,0,1919,20,16,0
2020-12-15T12:30:33.512958,52.538019999999996,13.3629566667, none, n,0.003232526340447,20,36,36,6715,2050,340,27,0,0,1919,20,16,0
2020-12-15T12:30:35.530599,52.53791,13.362988333299999, none, n,0.0033809306935380003,20,35,35,6491,1888,335,25,0,0,1919,20,15,0
2020-12-15T12:30:36.547526,52.5378833333,13.362998333299998, none, n,0.0033809306935380003,20,35,35,6491,1888,335,25,0,0,1919,20,15,0
2020-12-15T12:30:37.564778,52.5378683333,13.3630083333, none, n,0.0033809306935380003,19,34,37,6482,1893,337,25,4,0,1919,19,15,3
2020-12-15T12:30:38.581036,52.53785,13.36302, none, n,0.0033809306935380003,19,34,37,6482,1893,337,25,4,0,1919,19,15,3
2020-12-15T12:30:39.598063,52.5378333333,13.363033333299999, none, n,0.0033809306935380003,19,36,38,6691,1913,345,27,4,0,1919,19,17,2
2020-12-15T12:30:40.615869,52.5378066667,13.363043333299998, none, n,0.0033809306935380003,19,36,38,6691,1913,345,27,4,0,1919,19,17,2
2020-12-15T12:30:41.632577,52.5378,13.3630666667, none, n,0.0033809306935380003,20,34,36,6715,2054,333,18,4,0,1919,20,14,2
2020-12-15T12:30:42.649115,52.537794999999996,13.36309, none, n,0.0033809306935380003,20,34,36,6715,2054,333,18,4,0,1919,20,14,2
2020-12-15T12:30:43.673487,52.5377883333,13.3631183333, none, ne,0.0023049731126639,20,33,35,6658,1906,318,16,4,0,1919,20,13,2
2020-12-15T12:30:44.690456,52.5377766667,13.3631433333, none, ne,0.0023049731126639,20,33,35,6658,1906,318,16,4,0,1919,20,13,2
2020-12-15T12:30:45.708068,52.537765,13.363171666700001, none, ne,0.0023049731126639,21,34,37,6778,2084,328,14,6,0,1919,21,13,3
2020-12-15T12:30:46.725435,52.537744999999994,13.3631966667, none, ne,0.0023049731126639,21,34,38,6972,2117,333,14,6,0,1919,21,13,4
2020-12-15T12:30:47.749352,52.5377183333,13.363218333299999, none, ne,0.0023049731126639,22,37,42,7271,2167,356,24,8,0,1919,22,15,5
2020-12-15T12:30:48.759612,52.5377133333,13.36325, none, ne,0.0023049731126639,24,39,43,7797,2372,356,22,8,0,1919,24,15,4
2020-12-15T12:30:49.785158,52.5376983333,13.363273333299999, none, ne,0.0023049731126639,25,40,45,8299,2572,368,22,8,0,1919,25,15,5
2020-12-15T12:30:50.803198,52.537684999999996,13.3633016667, none, ne,0.0023049731126639,26,42,47,8711,2621,381,29,8,0,1919,26,16,5
2020-12-15T12:30:51.823172,52.53767,13.363335000000001, none, ne,0.0028134916283049,27,44,49,8998,2659,519,29,8,2,1919,27,17,5
2020-12-15T12:30:52.839214,52.5376383333,13.363365, none, ne,0.0028134916283049,27,44,49,9222,2819,531,27,8,2,1919,27,17,5
2020-12-15T12:30:53.855200,52.5376083333,13.363395, none, ne,0.0028134916283049,26,43,49,8825,2646,531,29,10,2,1919,26,17,6
2020-12-15T12:30:54.871972,52.5375816667,13.363425, none, ne,0.0028134916283049,27,45,51,8974,2649,536,29,10,2,1919,27,18,6
2020-12-15T12:30:55.888273,52.53756,13.36345, none, ne,0.0028134916283049,25,43,48,8547,2590,528,29,8,2,1919,25,18,5
2020-12-15T12:30:56.903797,52.5375466667,13.3634783333, none, ne,0.0028134916283049,24,42,48,8278,2415,541,29,10,2,1919,24,18,6
2020-12-15T12:30:57.920577,52.537535,13.363513333299998, none, ne,0.0028134916283049,23,39,44,8021,2385,543,17,8,2,1919,23,16,5
2020-12-15T12:30:58.936485,52.537515,13.363543333299999, none, ne,0.0028134916283049,23,39,44,8021,2385,543,17,8,2,1919,23,16,5
2020-12-15T12:30:59.953076,52.5375016667,13.363579999999999, none, ne,0.003571209540266,21,38,43,7698,2323,543,19,8,2,1919,21,17,5
2020-12-15T12:31:00.969477,52.5374883333,13.3636166667, none, ne,0.003571209540266,21,38,43,7698,2323,543,19,8,2,1919,21,17,5
2020-12-15T12:31:01.985340,52.5374516667,13.36365, none, ne,0.003571209540266,20,38,44,7256,2143,551,21,10,4,1919,20,18,6
2020-12-15T12:31:03.002032,52.5374216667,13.363688333299999, none, ne,0.003571209540266,20,38,44,7256,2143,551,21,10,4,1919,20,18,6
2020-12-15T12:31:04.019119,52.537395,13.363729999999999, none, ne,0.003571209540266,19,34,41,6754,2076,531,14,10,4,1919,19,15,7
2020-12-15T12:31:05.041975,52.5373616667,13.3637716667, none, ne,0.003571209540266,19,34,41,6754,2076,531,14,10,4,1919,19,15,7
2020-12-15T12:31:06.064133,52.537335,13.36382, none, ne,0.003571209540266,17,33,36,6252,1876,524,10,6,2,1919,17,16,3
2020-12-15T12:31:07.080135,52.5373116667,13.3638666667, none, ne,0.0040964086603011,17,33,36,6252,1876,524,10,6,2,1919,17,16,3
2020-12-15T12:31:08.096057,52.5372933333,13.3639116667, none, ne,0.0040964086603011,18,33,38,6216,1866,524,14,8,4,1919,18,15,5
2020-12-15T12:31:09.111811,52.5372866667,13.36396, none, ne,0.0040964086603011,18,33,38,6216,1866,524,14,8,4,1919,18,15,5
2020-12-15T12:31:10.129012,52.5372533333,13.364, none, ne,0.0040964086603011,18,33,38,6013,1849,521,14,8,4,1919,18,15,5
2020-12-15T12:31:11.144453,52.5372133333,13.3640366667, none, ne,0.0040964086603011,18,32,38,5983,1846,538,16,8,4,1919,18,14,6
2020-12-15T12:31:12.160246,52.537175,13.364075, none, ne,0.0040964086603011,17,32,37,5938,1833,541,14,8,4,1919,17,15,5
2020-12-15T12:31:13.176219,52.537144999999995,13.364118333299999, none, ne,0.0040964086603011,18,33,38,5974,1845,531,19,8,4,1919,18,15,5
2020-12-15T12:31:14.192071,52.5371283333,13.364170000000001, none, ne,0.0040964086603011,18,31,38,5953,1828,514,21,10,4,1919,18,13,7
2020-12-15T12:31:15.209140,52.5371166667,13.3642266667, none, ne,0.0046576185935002,17,33,41,5923,1823,522,23,12,4,1919,17,16,8
2020-12-15T12:31:16.224838,52.53711,13.364285, none, ne,0.0046576185935002,19,33,41,5998,1838,519,25,12,2,1919,19,14,8
2020-12-15T12:31:17.240483,52.537105000000004,13.364343333299999, none, ne,0.0046576185935002,19,35,44,6252,1861,534,32,14,2,1919,19,16,9
2020-12-15T12:31:18.256559,52.5370966667,13.364403333299999, none, ne,0.0046576185935002,19,35,43,6482,1893,516,32,14,2,1919,19,16,8
2020-12-15T12:31:19.272730,52.537085,13.3644616667, none, ne,0.0046576185935002,19,34,41,6458,1878,381,28,12,0,1919,19,15,7
2020-12-15T12:31:20.288796,52.5370616667,13.364514999999999, none, ne,0.0046576185935002,20,36,42,6727,2050,524,26,10,0,1919,20,16,6
2020-12-15T12:31:21.305327,52.53702,13.3645566667, none, ne,0.0046576185935002,19,36,44,6742,2050,524,31,12,2,1919,19,17,8
2020-12-15T12:31:22.320741,52.5369983333,13.3646033333, none, ne,0.0046576185935002,20,37,44,6990,2072,531,33,12,2,1919,20,17,7
2020-12-15T12:31:23.336937,52.5369866667,13.36466, none, e,0.0046684265204862,20,37,44,6990,2072,531,33,12,2,1919,20,17,7
2020-12-15T12:31:24.353974,52.5369683333,13.364720000000002, none, e,0.0046684265204862,20,37,43,7035,2082,533,26,10,2,1919,20,17,6
2020-12-15T12:31:25.370394,52.536948333299996,13.364776666700001, none, e,0.0046684265204862,20,37,43,7035,2082,533,26,10,2,1919,20,17,6
2020-12-15T12:31:26.387557,52.536925,13.364828333299998, none, e,0.0046684265204862,21,37,42,7208,2101,538,24,8,2,1919,21,16,5
2020-12-15T12:31:27.404079,52.5369083333,13.3648816667, none, e,0.0046684265204862,21,37,42,7208,2101,538,24,8,2,1919,21,16,5
2020-12-15T12:31:28.421856,52.536903333299996,13.364939999999999, none, e,0.0046684265204862,21,37,42,7268,2118,533,22,8,2,1919,21,16,5
2020-12-15T12:31:29.442462,52.5368683333,13.3649883333, none, e,0.0046684265204862,21,37,42,7268,2118,533,22,8,2,1919,21,16,5
2020-12-15T12:31:30.463549,52.53683,13.3650333333, none, e,0.0046684265204862,21,37,42,7268,2120,528,22,8,2,1919,21,16,5
2020-12-15T12:31:31.480439,52.5367883333,13.365058333299999, none, ne,0.0049737916739301,21,37,42,7268,2120,528,22,8,2,1919,21,16,5
2020-12-15T12:31:32.497833,52.536744999999996,13.3650616667, none, ne,0.0049737916739301,21,36,39,7187,2102,520,15,6,2,1919,21,15,3
2020-12-15T12:31:33.514708,52.536744999999996,13.365135, none, ne,0.0049737916739301,21,36,39,7187,2102,520,15,6,2,1919,21,15,3
2020-12-15T12:31:35.531123,52.5368266667,13.365386666700001, none, ne,0.0049737916739301,20,36,39,7002,2087,545,15,6,2,1919,20,16,3
2020-12-15T12:31:36.549494,52.5368533333,13.365445000000001, none, ne,0.0049737916739301,20,36,39,7002,2087,545,15,6,2,1919,20,16,3
2020-12-15T12:31:37.566572,52.5368666667,13.3654966667, none, ne,0.0049737916739301,21,36,39,7011,2097,542,15,6,2,1919,21,15,3
2020-12-15T12:31:38.583405,52.536880000000004,13.3655383333, none, ne,0.0049737916739301,21,36,39,7011,2097,542,15,6,2,1919,21,15,3
2020-12-15T12:31:39.604061,52.53689,13.3655766667, none, e,0.0052621279444087,20,34,40,6778,2060,537,19,10,2,1919,20,14,6
2020-12-15T12:31:40.620910,52.536894999999994,13.365611666700001, none, e,0.0052621279444087,20,34,40,6778,2060,537,19,10,2,1919,20,14,6
2020-12-15T12:31:41.637861,52.536901666700004,13.3656433333, none, e,0.0052621279444087,20,33,37,6712,1910,512,16,8,0,1919,20,13,4
2020-12-15T12:31:42.654452,52.5369066667,13.3656766667, none, e,0.0052621279444087,20,33,37,6712,1910,512,16,8,0,1919,20,13,4
2020-12-15T12:31:43.671252,52.5369083333,13.365713333299999, none, e,0.0052621279444087,20,32,36,6524,1898,362,14,8,0,1919,20,12,4
2020-12-15T12:31:44.688337,52.5368983333,13.3657483333, none, e,0.0052621279444087,20,32,36,6524,1898,362,14,8,0,1919,20,12,4
2020-12-15T12:31:45.706299,52.5368816667,13.3657816667, none, e,0.0052621279444087,20,31,36,6509,1898,355,14,8,0,1919,20,11,5
2020-12-15T12:31:46.723435,52.536856666700004,13.36581, none, e,0.0052621279444087,20,31,36,6509,1898,355,14,8,0,1919,20,11,5
2020-12-15T12:31:47.744342,52.536834999999996,13.3658366667, none, e,0.0026597447709184,20,31,37,6712,1911,352,16,10,2,1919,20,11,6
2020-12-15T12:31:48.764513,52.5368,13.365854999999998, none, e,0.0026597447709184,20,31,37,6712,1911,352,16,10,2,1919,20,11,6
2020-12-15T12:31:49.780617,52.536768333299996,13.3658716667, none, e,0.0026597447709184,20,31,36,6718,1914,352,14,8,2,1919,20,11,5
2020-12-15T12:31:50.797329,52.5367166667,13.3658783333, none, e,0.0026597447709184,20,31,36,6718,1914,352,14,8,2,1919,20,11,5
2020-12-15T12:31:51.817420,52.536665,13.365886666700002, none, e,0.0026597447709184,20,31,36,6694,1900,355,12,8,2,1919,20,11,5
2020-12-15T12:31:52.833987,52.536625,13.365901666700001, none, e,0.0026597447709184,20,31,36,6694,1900,355,12,8,2,1919,20,11,5
2020-12-15T12:31:53.849768,52.5365916667,13.3659216667, none, e,0.0026597447709184,21,32,37,6948,2070,365,12,8,2,1919,21,11,5
2020-12-15T12:31:54.866543,52.536559999999994,13.365943333299999, none, e,0.0026597447709184,21,32,37,6948,2070,365,12,8,2,1919,21,11,5
2020-12-15T12:31:55.883343,52.5365316667,13.3659666667, none, ne,0.0049794834009849,21,31,36,6918,2053,345,12,8,2,1919,21,10,5
2020-12-15T12:31:56.900314,52.5365033333,13.365981666700002, none, ne,0.0049794834009849,19,31,36,6694,1885,348,16,8,2,1919,19,12,5
2020-12-15T12:31:57.918466,52.536476666700004,13.365996666700001, none, ne,0.0049794834009849,20,32,35,6948,2050,338,12,4,2,1919,20,12,3
2020-12-15T12:31:58.932690,52.5364433333,13.3660116667, none, ne,0.0049794834009849,21,34,36,7208,2092,366,10,4,2,1919,21,13,2
2020-12-15T12:31:59.953691,52.5363966667,13.366025, none, ne,0.0049794834009849,21,36,40,7447,2122,516,19,6,2,1919,21,15,4
2020-12-15T12:32:00.970062,52.5363583333,13.366043333299999, none, ne,0.0049794834009849,21,37,41,7253,2100,528,23,6,2,1919,21,16,4
2020-12-15T12:32:01.986643,52.5363333333,13.3660616667, none, ne,0.0049794834009849,21,41,43,7447,2125,548,30,4,0,1919,21,20,2
2020-12-15T12:32:03.004740,52.5363016667,13.366081666700001, none, ne,0.0049794834009849,23,44,47,7770,2312,578,32,4,0,1919,23,21,3
2020-12-15T12:32:04.027869,52.536280000000005,13.366114999999999, none, ne,0.0042468701149915,24,47,48,8057,2374,585,34,2,0,1919,24,23,1
2020-12-15T12:32:05.038258,52.5362616667,13.3661566667, none, ne,0.0042468701149915,25,47,48,8194,2382,573,36,2,0,1919,25,22,1
2020-12-15T12:32:06.063971,52.536253333299996,13.3662016667, none, ne,0.0042468701149915,25,49,50,8290,2402,576,40,2,0,1919,25,24,1
2020-12-15T12:32:07.082169,52.5362466667,13.3662533333, none, ne,0.0042468701149915,27,50,51,8723,2590,588,38,2,0,1919,27,23,1
2020-12-15T12:32:08.105440,52.536235,13.366295000000001, none, ne,0.0042468701149915,27,51,52,8723,2595,588,40,2,0,1919,27,24,1
2020-12-15T12:32:09.120601,52.5362,13.366325, none, ne,0.0042468701149915,27,51,52,8723,2595,588,40,2,0,1919,27,24,1
2020-12-15T12:32:10.140104,52.5361433333,13.3663416667, none, ne,0.0042468701149915,27,49,51,8523,2578,560,40,4,0,1919,27,22,2
2020-12-15T12:32:11.164997,52.5361066667,13.366368333299999, none, ne,0.0036840997090250003,26,47,48,8209,2405,538,33,2,0,1919,26,21,1
2020-12-15T12:32:12.180777,52.53604,13.3663816667, none, ne,0.0036840997090250003,27,46,47,8284,2560,528,29,2,0,1919,27,19,1
2020-12-15T12:32:13.198564,52.5359933333,13.366401666700002, none, ne,0.0036840997090250003,26,42,44,7985,2385,383,20,2,0,1919,26,16,2
2020-12-15T12:32:14.215170,52.535934999999995,13.366418333299999, none, ne,0.0036840997090250003,24,40,41,7707,2333,358,25,2,0,1919,24,16,1
2020-12-15T12:32:15.234039,52.5358916667,13.3664416667, none, ne,0.0036840997090250003,24,40,41,7519,2315,363,21,2,0,1919,24,16,1
2020-12-15T12:32:16.253966,52.5358616667,13.366470000000001, none, ne,0.0036840997090250003,23,40,41,7465,2162,378,21,2,0,1919,23,17,1
2020-12-15T12:32:17.257222,52.5358466667,13.366506666700001, none, ne,0.0036840997090250003,23,39,42,7256,2157,516,19,2,0,1919,23,16,3
2020-12-15T12:32:18.278474,52.535825,13.3665416667, none, ne,0.0036840997090250003,22,39,42,7220,2139,381,19,4,0,1919,22,17,3
2020-12-15T12:32:19.297636,52.53578,13.3665683333, none, ne,0.0055372594432023,22,39,43,7244,2147,524,19,4,0,1919,22,17,4
2020-12-15T12:32:20.321725,52.53572,13.3665866667, none, ne,0.0055372594432023,22,40,41,7286,2157,534,17,2,0,1919,22,18,1
2020-12-15T12:32:21.343847,52.5356416667,13.366595000000002, none, ne,0.0055372594432023,22,40,42,7450,2305,541,17,4,0,1919,22,18,2
2020-12-15T12:32:22.363024,52.5355883333,13.3666216667, none, ne,0.0055372594432023,22,41,44,7471,2317,556,21,4,0,1919,22,19,3
2020-12-15T12:32:23.379505,52.535536666700004,13.366648333299999, none, ne,0.0055372594432023,23,40,45,7695,2331,543,23,6,0,1919,23,17,5
2020-12-15T12:32:24.400538,52.53548000000001,13.3666733333, none, ne,0.0055372594432023,24,39,44,7704,2333,535,18,6,0,1919,24,15,5
2020-12-15T12:32:25.422290,52.5354316667,13.366693333299999, none, ne,0.0055372594432023,24,39,44,7704,2333,535,18,6,0,1919,24,15,5
2020-12-15T12:32:26.438139,52.5353833333,13.3667166667, none, ne,0.0055372594432023,22,38,43,7749,2333,528,20,8,0,1919,22,16,5
2020-12-15T12:32:27.453484,52.535340000000005,13.366738333299999, none, n,0.0071798163520862,22,38,43,7749,2333,528,20,8,0,1919,22,16,5
2020-12-15T12:32:28.469185,52.53530500000001,13.3667616667, none, n,0.0071798163520862,23,39,44,7952,2360,528,20,8,0,1919,23,16,5
2020-12-15T12:32:29.484562,52.5352516667,13.3667783333, none, n,0.0071798163520862,23,39,44,7952,2360,528,20,8,0,1919,23,16,5
2020-12-15T12:32:30.502019,52.535221666700004,13.366805, none, n,0.0071798163520862,24,41,45,8018,2377,530,20,8,0,1919,24,17,4
2020-12-15T12:32:32.526432,52.5351183333,13.366883333299999, none, n,0.0071798163520862,24,41,45,8018,2377,530,20,8,0,1919,24,17,4
2020-12-15T12:32:33.543795,52.535111666700004,13.366923333299999, none, n,0.0071798163520862,27,42,47,8571,2603,532,20,8,0,1919,27,15,5
2020-12-15T12:32:34.563566,52.5351033333,13.3669616667, none, n,0.0071798163520862,27,42,47,8571,2603,532,20,8,0,1919,27,15,5
2020-12-15T12:32:35.584082,52.5351016667,13.36701, none, ne,0.0046069128929991,27,39,44,8511,2576,379,18,8,0,1919,27,12,5
2020-12-15T12:32:36.600430,52.5350733333,13.36705, none, ne,0.0046069128929991,27,40,46,8723,2598,382,20,8,0,1919,27,13,6
2020-12-15T12:32:37.621528,52.5350483333,13.367085000000001, none, ne,0.0046069128929991,28,45,50,9249,2665,528,27,8,2,1919,28,17,5
2020-12-15T12:32:38.638774,52.535005000000005,13.367115, none, ne,0.0046069128929991,27,44,49,9070,2638,513,23,8,2,1919,27,17,5
2020-12-15T12:32:39.655673,52.5349833333,13.36715, none, ne,0.0046069128929991,28,46,50,9297,2686,543,23,6,2,1919,28,18,4
2020-12-15T12:32:40.673278,52.534969999999994,13.3671916667, none, ne,0.0046069128929991,30,48,53,9778,2877,563,25,8,2,1919,30,18,5
2020-12-15T12:32:41.691475,52.53496,13.367235, none, ne,0.0046069128929991,30,49,53,9799,2885,568,25,6,2,1919,30,19,4
2020-12-15T12:32:42.709356,52.53495,13.3672783333, none, ne,0.0046069128929991,30,49,54,9996,2900,560,27,8,2,1919,30,19,5
2020-12-15T12:32:43.726518,52.5349283333,13.3673183333, none, ne,0.0040567486883751,31,49,54,10002,2900,558,25,8,2,1919,31,18,5
2020-12-15T12:32:44.757003,52.5348616667,13.367335, none, ne,0.0040567486883751,29,49,53,9757,2852,563,25,6,2,1919,29,20,4
2020-12-15T12:32:45.767593,52.5348116667,13.367358333299999, none, ne,0.0040567486883751,31,51,55,10253,2934,581,25,6,2,1919,31,20,4
2020-12-15T12:32:46.791865,52.5347733333,13.367386666700002, none, ne,0.0040567486883751,32,52,56,10567,3117,606,23,6,2,1919,32,20,4
2020-12-15T12:32:47.813209,52.5347433333,13.3674233333, none, ne,0.0040567486883751,32,52,54,10501,3097,613,16,4,0,1919,32,20,2
2020-12-15T12:32:48.829379,52.5347,13.367455, none, ne,0.0040567486883751,32,52,54,10501,3097,613,16,4,0,1919,32,20,2
2020-12-15T12:32:49.846065,52.5346583333,13.367485, none, ne,0.0040567486883751,32,52,54,10537,3112,618,16,4,0,1919,32,20,2
2020-12-15T12:32:50.867528,52.5346433333,13.3675216667, none, ne,0.0040567486883751,30,49,53,10056,2909,603,16,6,0,1919,30,19,4
2020-12-15T12:32:51.879404,52.5346316667,13.3675633333, none, ne,0.0052737199329609,29,49,52,9769,2871,588,14,6,0,1919,29,20,3
2020-12-15T12:32:52.903238,52.5346233333,13.3676033333, none, ne,0.0052737199329609,28,46,49,9073,2653,570,14,6,0,1919,28,18,3
2020-12-15T12:32:53.920831,52.5345916667,13.367633333299999, none, ne,0.0052737199329609,32,56,61,10812,3153,785,29,8,0,1919,32,24,5
2020-12-15T12:32:54.940240,52.5345433333,13.367655, none, ne,0.0052737199329609,32,57,63,11060,3173,782,33,8,0,1919,32,25,6
2020-12-15T12:32:55.962185,52.5344983333,13.367675, none, ne,0.0052737199329609,32,55,62,10615,3126,772,33,10,0,1919,32,23,7
2020-12-15T12:32:56.977337,52.5344683333,13.367704999999999, none, ne,0.0052737199329609,30,53,59,10247,2916,624,35,12,0,1919,30,23,6
2020-12-15T12:32:57.992728,52.5344383333,13.367738333299998, none, ne,0.0052737199329609,30,53,62,10083,2901,601,42,14,2,1919,30,23,9
2020-12-15T12:32:59.017688,52.5344116667,13.367771666700001, none, ne,0.0052737199329609,30,51,59,10029,2891,581,40,14,2,1919,30,21,8
2020-12-15T12:33:00.035315,52.5343966667,13.3678083333, none, ne,0.0044203155032714,30,51,59,10008,2883,579,40,14,2,1919,30,21,8
2020-12-15T12:33:01.053237,52.534373333299996,13.3678433333, none, ne,0.0044203155032714,30,52,63,10247,2915,594,42,16,4,1919,30,22,11
2020-12-15T12:33:02.069210,52.5343533333,13.367878333299998, none, ne,0.0044203155032714,29,52,63,10038,2895,612,44,16,4,1919,29,23,11
2020-12-15T12:33:03.090150,52.5343083333,13.367904999999999, none, ne,0.0044203155032714,29,52,63,10038,2895,612,44,16,4,1919,29,23,11
2020-12-15T12:33:04.114370,52.534283333299996,13.3679366667, none, ne,0.0044203155032714,30,54,64,10516,3083,615,44,16,4,1919,30,24,10
2020-12-15T12:33:05.133108,52.534265000000005,13.367973333299998, none, ne,0.0044203155032714,30,54,64,10516,3083,615,44,16,4,1919,30,24,10
2020-12-15T12:33:06.152312,52.5342266667,13.368001666700001, none, ne,0.0044203155032714,25,43,51,8550,2430,531,27,12,4,1919,25,18,8
2020-12-15T12:33:07.173238,52.534193333299996,13.36803, none, ne,0.0044203155032714,25,43,51,8550,2430,531,27,12,4,1919,25,18,8
2020-12-15T12:33:08.189831,52.5341683333,13.368065, none, ne,0.0043939178489731,25,44,51,8490,2417,539,32,12,4,1919,25,19,7
2020-12-15T12:33:09.205832,52.534135,13.368096666700001, none, ne,0.0043939178489731,25,44,51,8490,2417,539,32,12,4,1919,25,19,7
2020-12-15T12:33:10.222606,52.53409499999999,13.3681266667, none, ne,0.0043939178489731,25,45,53,8484,2419,554,32,12,6,1919,25,20,8
2020-12-15T12:33:11.239481,52.5340483333,13.368153333299999, none, ne,0.0043939178489731,25,45,53,8484,2419,554,32,12,6,1919,25,20,8
2020-12-15T12:33:12.256265,52.5340016667,13.3681766667, none, ne,0.0043939178489731,26,45,53,8723,2574,569,32,12,6,1919,26,19,8
2020-12-15T12:33:13.275209,52.53397,13.368208333299998, none, ne,0.0043939178489731,26,45,53,8723,2574,569,32,12,6,1919,26,19,8
2020-12-15T12:33:14.293846,52.5339633333,13.36825, none, ne,0.0043939178489731,25,42,49,8063,2369,559,25,10,4,1919,25,17,7
2020-12-15T12:33:15.310034,52.533955000000006,13.368288333299999, none, ne,0.0043939178489731,25,42,49,8063,2369,559,25,10,4,1919,25,17,7
2020-12-15T12:33:16.330253,52.5339616667,13.368336666700001, none, ne,0.004203358652262,24,42,49,8042,2367,552,27,12,4,1919,24,18,7
2020-12-15T12:33:17.355308,52.5339666667,13.368378333299999, none, ne,0.004203358652262,24,42,49,8042,2367,552,27,12,4,1919,24,18,7
2020-12-15T12:33:18.372195,52.5339533333,13.36841, none, ne,0.004203358652262,24,41,49,8033,2358,549,27,12,4,1919,24,17,8
2020-12-15T12:33:19.389005,52.5339383333,13.3684433333, none, ne,0.004203358652262,24,41,49,8033,2358,549,27,12,4,1919,24,17,8
2020-12-15T12:33:20.406032,52.533915,13.368475, none, ne,0.004203358652262,25,41,46,8245,2388,534,23,8,2,1919,25,16,5
2020-12-15T12:33:21.423427,52.5339,13.36851, none, ne,0.004203358652262,25,41,46,8245,2388,534,23,8,2,1919,25,16,5
2020-12-15T12:33:22.440328,52.533875,13.36854, none, ne,0.004203358652262,27,43,47,8762,2589,531,21,6,2,1919,27,16,4
2020-12-15T12:33:23.456296,52.53386,13.368575, none, ne,0.004203358652262,29,46,51,9324,2679,551,26,8,4,1919,29,17,5
2020-12-15T12:33:24.474745,52.533840000000005,13.368606666700002, none, ne,0.0032468053186229,29,47,54,9572,2840,556,31,10,4,1919,29,18,7
2020-12-15T12:33:25.495093,52.5338216667,13.36864, none, ne,0.0032468053186229,31,47,53,10008,2898,558,22,10,4,1919,31,16,6
2020-12-15T12:33:26.514140,52.5338166667,13.368675, none, ne,0.0032468053186229,32,48,53,10083,2913,548,24,8,2,1919,32,16,5
2020-12-15T12:33:28.531035,52.5338083333,13.3687766667, none, ne,0.0032468053186229,31,50,56,10038,2908,558,29,8,4,1919,31,19,6
2020-12-15T12:33:29.547639,52.5338066667,13.368804999999998, none, ne,0.0032468053186229,32,52,58,10322,3090,571,33,8,4,1919,32,20,6
2020-12-15T12:33:30.565274,52.5338,13.3688316667, none, ne,0.0032468053186229,32,56,60,10576,3125,603,33,6,4,1919,32,24,4
2020-12-15T12:33:31.582496,52.5338,13.3688666667, none, ne,0.0032468053186229,32,55,59,10570,3127,601,33,6,4,1919,32,23,4
2020-12-15T12:33:32.603395,52.5338216667,13.3689133333, none, e,0.0029775097818694,32,54,59,10343,3087,599,35,8,4,1919,32,22,5
2020-12-15T12:33:33.615261,52.5338483333,13.368960000000001, none, e,0.0029775097818694,31,53,58,10089,2929,594,35,8,4,1919,31,22,5
2020-12-15T12:33:34.634693,52.533875,13.369000000000002, none, e,0.0029775097818694,29,49,53,9542,2849,561,30,6,2,1919,29,20,4
2020-12-15T12:33:35.654716,52.53391,13.369036666700001, none, e,0.0029775097818694,30,47,50,9542,2849,553,23,4,2,1919,30,17,3
2020-12-15T12:33:36.673108,52.5339433333,13.3690733333, none, e,0.0029775097818694,30,47,51,9542,2849,553,23,4,2,1919,30,17,4
2020-12-15T12:33:37.693731,52.5339766667,13.3691166667, none, e,0.0029775097818694,29,46,52,9303,2686,551,27,8,4,1919,29,17,6
2020-12-15T12:33:38.710921,52.534015000000004,13.3691566667, none, e,0.0029775097818694,29,46,52,9303,2686,551,27,8,4,1919,29,17,6
2020-12-15T12:33:39.727690,52.53404499999999,13.3691966667, none, e,0.0029775097818694,28,44,49,9031,2647,536,23,8,4,1919,28,16,5
2020-12-15T12:33:40.744618,52.5340733333,13.36924, none, se,0.0050936434175948,28,44,49,9031,2647,536,23,8,4,1919,28,16,5
2020-12-15T12:33:41.763081,52.5340983333,13.3692866667, none, se,0.0050936434175948,28,44,48,9040,2657,538,23,6,2,1919,28,16,4
2020-12-15T12:33:42.779910,52.5341233333,13.369335000000001, none, se,0.0050936434175948,27,42,46,8771,2610,530,19,6,2,1919,27,15,4
2020-12-15T12:33:43.795493,52.53415,13.3693816667, none, se,0.0050936434175948,25,39,43,8239,2400,380,17,6,2,1919,25,14,4
2020-12-15T12:33:44.813976,52.5341766667,13.3694266667, none, se,0.0050936434175948,25,40,44,8275,2417,515,17,6,2,1919,25,15,4
2020-12-15T12:33:45.830172,52.5342033333,13.3694716667, none, se,0.0050936434175948,25,40,43,8230,2417,515,17,4,2,1919,25,15,3
2020-12-15T12:33:46.846080,52.53423000000001,13.369513333299999, none, se,0.0050936434175948,23,38,41,7764,2340,375,17,4,2,1919,23,15,3
2020-12-15T12:33:47.865575,52.5342533333,13.369558333299999, none, se,0.0050936434175948,23,38,41,7704,2332,526,15,4,2,1919,23,15,3
2020-12-15T12:33:48.880098,52.5342766667,13.369601666700001, none, se,0.0047586846554318,23,39,41,7713,2332,529,15,4,2,1919,23,16,2
2020-12-15T12:33:49.897316,52.5343016667,13.369641666700002, none, se,0.0047586846554318,22,37,37,7256,2134,519,11,0,0,1919,22,15,0
2020-12-15T12:33:50.913704,52.5343316667,13.3696816667, none, se,0.0047586846554318,22,38,38,7295,2143,537,13,0,0,1919,22,16,0
2020-12-15T12:33:51.930532,52.53435,13.3697183333, none, se,0.0047586846554318,21,36,36,7032,2098,522,8,0,0,1919,21,15,0
2020-12-15T12:33:52.952143,52.534371666700004,13.3697566667, none, se,0.0047586846554318,21,35,35,6987,2076,512,8,0,0,1919,21,14,0
2020-12-15T12:33:53.972929,52.5343783333,13.3698, none, se,0.0047586846554318,21,33,33,6996,2061,359,10,0,0,1919,21,12,0
2020-12-15T12:33:54.986510,52.5343816667,13.369845000000002, none, se,0.0047586846554318,21,33,33,6996,2061,359,10,0,0,1919,21,12,0
2020-12-15T12:33:56.003872,52.5343666667,13.3698716667, none, se,0.0047586846554318,21,31,32,6781,1899,337,12,2,0,1919,21,10,1
2020-12-15T12:33:57.020500,52.5343566667,13.369888333299999, none, e,0.0030475410600782,21,31,32,6781,1899,337,12,2,0,1919,21,10,1
2020-12-15T12:33:58.038969,52.5343383333,13.3699083333, none, e,0.0030475410600782,21,31,32,6760,1885,332,12,2,0,1919,21,10,1
2020-12-15T12:33:59.050733,52.534315,13.3699233333, none, e,0.0030475410600782,21,31,32,6760,1885,332,12,2,0,1919,21,10,1
2020-12-15T12:34:00.072720,52.5342883333,13.369938333299999, none, e,0.0030475410600782,22,32,33,7038,2075,347,12,2,0,1919,22,10,1
2020-12-15T12:34:01.088989,52.5342583333,13.369933333299999, none, e,0.0030475410600782,22,32,33,7038,2075,347,12,2,0,1919,22,10,1
2020-12-15T12:34:02.106034,52.5342433333,13.369921666700002, none, e,0.0030475410600782,21,31,32,6778,1900,334,12,2,0,1919,21,10,1
2020-12-15T12:34:03.128133,52.534234999999995,13.3699033333, none, e,0.0030475410600782,19,29,30,6192,1800,321,12,2,0,1919,19,10,1
2020-12-15T12:34:04.138755,52.5342233333,13.369875, none, n,0.0021219511640185,19,29,31,6183,1803,321,16,2,0,1919,19,10,2
2020-12-15T12:34:05.164070,52.5342266667,13.369835, none, n,0.0021219511640185,18,29,32,5989,1653,313,18,6,2,1919,18,11,3
2020-12-15T12:34:06.179995,52.53423000000001,13.369795000000002, none, n,0.0021219511640185,18,29,32,6147,1658,321,16,6,2,1919,18,11,3
2020-12-15T12:34:07.196088,52.5342266667,13.369751666700001, none, n,0.0021219511640185,19,30,35,6264,1823,334,18,6,2,1919,19,11,5
2020-12-15T12:34:08.212363,52.5342316667,13.369701666700001, none, n,0.0021219511640185,19,31,37,6225,1830,354,20,8,4,1919,19,12,6
2020-12-15T12:34:09.229570,52.5342233333,13.369656666700001, none, n,0.0021219511640185,19,32,38,6404,1840,379,20,6,4,1919,19,13,6
2020-12-15T12:34:10.247183,52.534209999999995,13.369615, none, n,0.0021219511640185,21,33,40,6509,1879,512,22,8,4,1919,21,12,7
2020-12-15T12:34:11.261590,52.534193333299996,13.369575, none, n,0.0021219511640185,20,32,39,6464,1854,369,20,8,4,1919,20,12,7
2020-12-15T12:34:12.278025,52.5342016667,13.3695316667, none, w,0.0033353602583614,21,33,40,6679,1884,367,22,8,4,1919,21,12,7
2020-12-15T12:34:13.294203,52.534234999999995,13.3694816667, none, w,0.0033353602583614,21,36,41,6927,1914,375,24,8,4,1919,21,15,5
2020-12-15T12:34:14.309829,52.534255,13.3694316667, none, w,0.0033353602583614,21,35,40,6748,1909,362,20,8,4,1919,21,14,5
2020-12-15T12:34:15.326584,52.534259999999996,13.36938, none, w,0.0033353602583614,21,35,40,6748,1909,362,20,8,4,1919,21,14,5
2020-12-15T12:34:16.344648,52.5342483333,13.36933, none, w,0.0033353602583614,21,35,38,6933,2064,370,18,4,2,1919,21,14,3
2020-12-15T12:34:17.350670,52.53422,13.369283333299999, none, w,0.0033353602583614,21,36,38,6939,2077,375,18,4,2,1919,21,15,2
2020-12-15T12:34:18.371664,52.5341916667,13.36924, none, w,0.0033353602583614,20,35,39,6521,1909,375,23,6,2,1919,20,15,4
2020-12-15T12:34:19.388594,52.534165,13.3691983333, none, w,0.0033353602583614,19,35,39,6470,1892,370,26,8,2,1919,19,16,4
2020-12-15T12:34:20.406452,52.5341333333,13.369155, none, w,0.0037980415393412,20,35,39,6231,1867,357,24,8,2,1919,20,15,4
2020-12-15T12:34:21.423068,52.5340933333,13.3691116667, none, w,0.0037980415393412,18,33,37,5923,1808,349,20,6,2,1919,18,15,4
2020-12-15T12:34:22.438927,52.53406,13.36907, none, w,0.0037980415393412,17,31,35,5451,1615,341,22,6,2,1919,17,14,4
2020-12-15T12:34:23.464343,52.5340333333,13.369033333299999, none, w,0.0037980415393412,16,30,35,5451,1618,351,22,6,2,1919,16,14,5
2020-12-15T12:34:24.479834,52.5340033333,13.369000000000002, none, w,0.0037980415393412,16,30,36,5233,1603,346,24,8,4,1919,16,14,6
2020-12-15T12:34:25.495776,52.53398000000001,13.368970000000001, none, w,0.0037980415393412,16,30,37,5391,1605,354,26,8,4,1919,16,14,7
2020-12-15T12:34:26.512999,52.5339583333,13.368948333299999, none, w,0.0037980415393412,15,29,36,5146,1571,349,28,8,4,1919,15,14,7
2020-12-15T12:34:28.529867,52.5339233333,13.368885, none, nw,0.0042349213405124,14,28,34,4937,1541,334,28,8,4,1919,14,14,6
2020-12-15T12:34:29.546281,52.5339216667,13.3688616667, none, nw,0.0042349213405124,14,29,34,5167,1566,344,28,6,4,1919,14,15,5
2020-12-15T12:34:30.563790,52.5339216667,13.368839999999999, none, nw,0.0042349213405124,15,30,32,5227,1586,354,25,2,2,1919,15,15,2
2020-12-15T12:34:31.580864,52.5339333333,13.368825, none, nw,0.0042349213405124,15,30,32,5227,1588,352,25,2,2,1919,15,15,2
2020-12-15T12:34:32.600162,52.5339433333,13.368813333299999, none, nw,0.0042349213405124,15,30,32,5227,1588,352,25,2,2,1919,15,15,2
2020-12-15T12:34:33.614366,52.533944999999996,13.368801666700001, none, nw,0.0042349213405124,15,31,32,5415,1605,355,25,2,2,1919,15,16,1
2020-12-15T12:34:34.633638,52.533925,13.3687916667, none, nw,0.0042349213405124,16,32,33,5415,1605,355,25,2,2,1919,16,16,1
2020-12-15T12:34:35.650172,52.5338183333,13.368763333299999, none, nw,0.0042349213405124,18,33,35,5908,1803,360,23,2,2,1919,18,15,2
2020-12-15T12:34:36.667333,52.5337083333,13.3687383333, none, nw,0.0036976795537307,18,33,35,5908,1803,360,23,2,2,1919,18,15,2
2020-12-15T12:34:37.684221,52.5337283333,13.36876, none, nw,0.0036976795537307,18,32,34,6165,1825,350,21,2,2,1919,18,14,2
2020-12-15T12:34:38.703570,52.5337516667,13.3688216667, none, nw,0.0036976795537307,18,32,34,6165,1825,350,21,2,2,1919,18,14,2
2020-12-15T12:34:39.720319,52.53369,13.3688266667, none, nw,0.0036976795537307,19,31,31,6234,1845,340,17,0,0,1919,19,12,0
2020-12-15T12:34:40.737461,52.5336666667,13.368856666700001, none, nw,0.0036976795537307,19,31,31,6234,1845,340,17,0,0,1919,19,12,0
2020-12-15T12:34:41.762006,52.5336283333,13.368879999999999, none, nw,0.0036976795537307,20,33,33,6473,1885,342,15,0,0,1919,20,13,0
2020-12-15T12:34:42.785407,52.5335883333,13.368901666700001, none, nw,0.0036976795537307,20,33,33,6473,1885,342,15,0,0,1919,20,13,0
2020-12-15T12:34:43.801675,52.533545,13.368920000000001, none, nw,0.0036976795537307,21,35,37,6975,2082,352,18,2,0,1919,21,14,2
2020-12-15T12:34:44.820517,52.5335133333,13.368945000000002, none, ne,0.0036854724221026,21,38,41,7184,2104,377,27,6,0,1919,21,17,3
2020-12-15T12:34:45.826142,52.533480000000004,13.368970000000001, none, ne,0.0036854724221026,23,37,41,7447,2154,372,20,6,0,1919,23,14,4
2020-12-15T12:34:46.845612,52.5334466667,13.368993333299999, none, ne,0.0036854724221026,24,37,40,7504,2164,369,16,6,0,1919,24,13,3
2020-12-15T12:34:47.862404,52.5334116667,13.369015, none, ne,0.0036854724221026,25,39,44,7788,2344,381,20,8,2,1919,25,14,5
2020-12-15T12:34:48.878695,52.5333833333,13.369046666700001, none, ne,0.0036854724221026,25,39,44,7758,2339,378,22,8,2,1919,25,14,5
2020-12-15T12:34:49.896485,52.533359999999995,13.369079999999999, none, ne,0.0036854724221026,24,40,45,7504,2309,514,26,8,2,1919,24,16,5
2020-12-15T12:34:50.913099,52.5333266667,13.369105, none, ne,0.0036854724221026,24,41,46,7510,2324,524,26,8,2,1919,24,17,5
2020-12-15T12:34:51.928750,52.533305000000006,13.369138333299999, none, ne,0.0036854724221026,24,41,46,7546,2337,531,26,8,2,1919,24,17,5
2020-12-15T12:34:52.945096,52.533280000000005,13.36917, none, ne,0.0042970945029646,24,43,48,7689,2339,544,30,8,2,1919,24,19,5
2020-12-15T12:34:53.962083,52.5332383333,13.36919, none, ne,0.0042970945029646,24,42,46,7501,2322,539,25,6,2,1919,24,18,4
2020-12-15T12:34:54.980061,52.533205,13.3692116667, none, ne,0.0042970945029646,25,41,44,7698,2349,524,18,4,2,1919,25,16,3
2020-12-15T12:34:55.997710,52.533186666700004,13.369238333299998, none, ne,0.0042970945029646,24,40,43,7465,2307,383,20,4,2,1919,24,16,3
2020-12-15T12:34:57.022007,52.533159999999995,13.369273333299999, none, ne,0.0042970945029646,24,40,43,7465,2307,383,20,4,2,1919,24,16,3
2020-12-15T12:34:58.046995,52.5331383333,13.369318333299999, none, ne,0.0042970945029646,24,40,43,7465,2312,381,20,4,2,1919,24,16,3
2020-12-15T12:34:59.050599,52.533125,13.369365, none, ne,0.0042970945029646,24,40,43,7465,2312,381,20,4,2,1919,24,16,3
2020-12-15T12:35:00.072601,52.533125,13.369411666700001, none, ne,0.0033934203211954,24,39,40,7495,2317,369,16,2,0,1919,24,15,1
2020-12-15T12:35:01.090401,52.5331316667,13.369461666700001, none, ne,0.0033934203211954,24,39,40,7495,2317,369,16,2,0,1919,24,15,1
2020-12-15T12:35:02.105598,52.5331366667,13.369504999999998, none, ne,0.0033934203211954,25,41,42,7967,2372,382,16,2,0,1919,25,16,1
2020-12-15T12:35:03.121720,52.5331283333,13.36955, none, ne,0.0033934203211954,25,41,42,7967,2372,382,16,2,0,1919,25,16,1
2020-12-15T12:35:04.137703,52.53312,13.369596666700001, none, ne,0.0033934203211954,25,40,41,7976,2360,379,12,2,0,1919,25,15,1
2020-12-15T12:35:05.154767,52.5330866667,13.3696316667, none, ne,0.0033934203211954,25,39,42,7940,2342,379,16,4,2,1919,25,14,3
2020-12-15T12:35:06.171242,52.5330466667,13.369660000000001, none, ne,0.0033934203211954,26,41,44,8218,2386,520,18,4,2,1919,26,15,3
2020-12-15T12:35:07.187303,52.53301,13.3696716667, none, ne,0.0033934203211954,27,41,44,8457,2426,522,14,4,2,1919,27,14,3
2020-12-15T12:35:08.205484,52.5329533333,13.3696716667, none, ne,0.0037078379990672,27,41,43,8493,2423,517,12,4,2,1919,27,14,2
2020-12-15T12:35:09.225723,52.53290500000001,13.369686666700002, none, ne,0.0037078379990672,27,41,43,8311,2399,517,14,2,2,1919,27,14,2
2020-12-15T12:35:10.237750,52.5328433333,13.369703333299999, none, ne,0.0037078379990672,27,42,45,8538,2561,537,14,4,2,1919,27,15,3
2020-12-15T12:35:11.250047,52.5328,13.369729999999999, none, ne,0.0037078379990672,28,43,48,8756,2593,547,18,6,2,1919,28,15,5
2020-12-15T12:35:12.270300,52.53276999999999,13.369748333299999, none, ne,0.0037078379990672,27,44,49,8553,2573,562,20,6,2,1919,27,17,5
2020-12-15T12:35:13.287935,52.532709999999994,13.3697633333, none, ne,0.0037078379990672,27,43,48,8493,2563,574,18,6,2,1919,27,16,5
2020-12-15T12:35:14.300048,52.5326516667,13.369785, none, ne,0.0037078379990672,28,48,51,8792,2625,587,25,6,2,1919,28,20,3
2020-12-15T12:35:15.323228,52.5326066667,13.3698083333, none, ne,0.0037078379990672,27,47,51,8529,2586,577,30,6,0,1919,27,20,4
2020-12-15T12:35:16.340390,52.5325733333,13.36984, none, ne,0.0062516232040937,26,47,51,8490,2564,572,32,6,0,1919,26,21,4
2020-12-15T12:35:17.344375,52.532534999999996,13.3698716667, none, ne,0.0062516232040937,26,47,51,8490,2564,572,32,6,0,1919,26,21,4
2020-12-15T12:35:18.365778,52.532495,13.3699033333, none, ne,0.0062516232040937,25,45,49,8197,2377,575,32,6,0,1919,25,20,4
2020-12-15T12:35:19.383987,52.5324633333,13.369933333299999, none, ne,0.0062516232040937,25,45,49,8197,2377,575,32,6,0,1919,25,20,4
2020-12-15T12:35:20.401400,52.532435,13.3699666667, none, ne,0.0062516232040937,24,44,48,7949,2343,565,32,6,0,1919,24,20,4
2020-12-15T12:35:21.418572,52.5323933333,13.369995000000001, none, ne,0.0062516232040937,24,44,48,7949,2343,565,32,6,0,1919,24,20,4
2020-12-15T12:35:22.447538,52.5323483333,13.370021666700001, none, ne,0.0062516232040937,24,42,45,7806,2338,562,28,6,0,1919,24,18,3
2020-12-15T12:35:23.464436,52.5323166667,13.3700533333, none, ne,0.0062516232040937,24,42,45,7806,2338,562,28,6,0,1919,24,18,3
2020-12-15T12:35:24.490704,52.532295,13.3700866667, none, ne,0.0050228812968324,23,40,42,7522,2156,540,26,4,0,1919,23,17,2
2020-12-15T12:35:25.508337,52.532265,13.370113333299999, none, ne,0.0050228812968324,23,40,42,7522,2156,540,26,4,0,1919,23,17,2
2020-12-15T12:35:27.514342,52.5321633333,13.3701916667, none, ne,0.0050228812968324,22,38,40,7247,2099,525,24,4,0,1919,22,16,2
2020-12-15T12:35:28.534295,52.5321383333,13.370221666700001, none, ne,0.0050228812968324,22,38,40,7247,2099,525,24,4,0,1919,22,16,2
2020-12-15T12:35:29.552016,52.5321016667,13.3702466667, none, ne,0.0050228812968324,22,36,39,7262,2077,515,22,4,0,1919,22,14,3
2020-12-15T12:35:30.569436,52.5320783333,13.370285, none, ne,0.0050228812968324,22,36,39,7262,2077,515,22,4,0,1919,22,14,3
2020-12-15T12:35:31.586547,52.53205,13.3703233333, none, ne,0.0050228812968324,22,35,37,7211,2059,360,22,4,0,1919,22,13,2
2020-12-15T12:35:32.606102,52.532023333299996,13.370356666700001, none, ne,0.0050427991586171,22,35,37,7211,2059,360,22,4,0,1919,22,13,2
2020-12-15T12:35:33.627552,52.5319833333,13.370385, none, ne,0.0050427991586171,21,32,35,6978,1891,340,15,4,0,1919,21,11,3
2020-12-15T12:35:34.654226,52.5319233333,13.370406666700001, none, ne,0.0050427991586171,21,32,35,6978,1891,340,15,4,0,1919,21,11,3
2020-12-15T12:35:35.653146,52.531859999999995,13.3704283333, none, ne,0.0050427991586171,22,35,38,7292,2078,370,18,4,2,1919,22,13,3
2020-12-15T12:35:36.680468,52.531819999999996,13.3704566667, none, ne,0.0050427991586171,21,35,38,6993,1910,380,21,6,2,1919,21,14,3
2020-12-15T12:35:37.705422,52.531796666700004,13.370488333299999, none, ne,0.0050427991586171,22,34,38,7032,1912,362,23,6,2,1919,22,12,4
2020-12-15T12:35:38.723665,52.531775,13.3705233333, none, ne,0.0050427991586171,21,35,39,7184,1919,367,23,6,2,1919,21,14,4
2020-12-15T12:35:39.728655,52.531755000000004,13.3705616667, none, ne,0.0050427991586171,21,35,38,6984,1904,360,25,6,2,1919,21,14,3
2020-12-15T12:35:40.736533,52.53173,13.370596666700001, none, ne,0.0052048409520196,21,34,38,6939,1896,360,25,6,2,1919,21,13,4
2020-12-15T12:35:41.756424,52.531705,13.3706283333, none, ne,0.0052048409520196,21,36,39,7184,2058,367,25,4,2,1919,21,15,3
2020-12-15T12:35:42.781930,52.5316533333,13.370655, none, ne,0.0052048409520196,21,37,40,6996,2058,364,32,4,2,1919,21,16,3
2020-12-15T12:35:43.804470,52.531596666700004,13.370683333299999, none, ne,0.0052048409520196,20,37,40,6742,1896,374,34,4,2,1919,20,17,3
2020-12-15T12:35:44.829148,52.5315316667,13.3707083333, none, ne,0.0052048409520196,19,37,40,6518,1879,379,38,4,2,1919,19,18,3
2020-12-15T12:35:45.845769,52.5314666667,13.370735, none, ne,0.0052048409520196,18,34,35,6240,1825,351,28,2,0,1919,18,16,1
2020-12-15T12:35:46.865526,52.53141,13.37076, none, ne,0.0052048409520196,19,34,35,6428,1835,346,30,2,0,1919,19,15,1
2020-12-15T12:35:47.879614,52.5313583333,13.370779999999998, none, ne,0.0052048409520196,18,34,38,6246,1833,359,32,6,2,1919,18,16,4
2020-12-15T12:35:48.895308,52.5313216667,13.370804999999999, none, ne,0.0067916088135897,18,34,38,6246,1833,359,32,6,2,1919,18,16,4
2020-12-15T12:35:49.912596,52.531305,13.370829999999998, none, ne,0.0067916088135897,18,34,38,6216,1833,356,32,6,2,1919,18,16,4
2020-12-15T12:35:50.930384,52.5312883333,13.3708516667, none, ne,0.0067916088135897,18,34,38,6216,1833,356,32,6,2,1919,18,16,4
2020-12-15T12:35:51.945929,52.531285,13.370865, none, ne,0.0067916088135897,19,36,40,6491,1877,378,30,6,2,1919,19,17,4
2020-12-15T12:35:52.966812,52.531255,13.370878333299999, none, ne,0.0067916088135897,19,36,40,6491,1877,378,30,6,2,1919,19,17,4
2020-12-15T12:35:53.995460,52.5312316667,13.3708966667, none, ne,0.0067916088135897,20,37,41,6664,1892,526,30,6,2,1919,20,17,4
2020-12-15T12:35:55.008391,52.5312133333,13.370913333299999, none, ne,0.0067916088135897,20,37,41,6664,1892,526,30,6,2,1919,20,17,4
2020-12-15T12:35:56.034021,52.53116,13.370928333299998, none, ne,0.0028311529029639,20,36,40,6440,1865,381,28,6,2,1919,20,16,4
2020-12-15T12:35:57.050050,52.531126666700004,13.370916666700001, none, ne,0.0028311529029639,20,36,40,6440,1865,381,28,6,2,1919,20,16,4
2020-12-15T12:35:58.073193,52.5310933333,13.3709033333, none, ne,0.0028311529029639,20,36,40,6673,1897,512,28,6,2,1919,20,16,4
2020-12-15T12:35:59.088445,52.53106,13.370878333299999, none, ne,0.0028311529029639,21,36,41,6933,2052,514,30,8,2,1919,21,15,5
2020-12-15T12:36:00.103645,52.531038333299996,13.3708516667, none, ne,0.0028311529029639,21,36,44,6984,2059,516,30,10,4,1919,21,15,8
2020-12-15T12:36:01.122012,52.5310166667,13.3708366667, none, ne,0.0028311529029639,21,38,45,7014,2076,521,32,10,4,1919,21,17,7
2020-12-15T12:36:02.136966,52.530995,13.37085, none, ne,0.0028311529029639,22,38,45,7450,2133,531,25,8,4,1919,22,16,7
2020-12-15T12:36:03.152298,52.5309566667,13.3708583333, none, ne,0.0028311529029639,24,41,43,7976,2340,538,21,4,2,1919,24,17,2
2020-12-15T12:36:04.174167,52.5309283333,13.370868333299999, none, n,0.0037254313710444,26,43,46,8472,2407,546,23,4,2,1919,26,17,3
2020-12-15T12:36:05.200017,52.530901666700004,13.3708816667, none, n,0.0037254313710444,25,41,45,8212,2370,524,25,6,2,1919,25,16,4
2020-12-15T12:36:06.211744,52.5308833333,13.3709016667, none, n,0.0037254313710444,26,46,50,8517,2422,536,42,6,2,1919,26,20,4
2020-12-15T12:36:07.234453,52.530858333299996,13.370920000000002, none, n,0.0037254313710444,28,49,53,9034,2632,563,46,6,2,1919,28,21,4
2020-12-15T12:36:08.257185,52.5308366667,13.3709383333, none, n,0.0037254313710444,28,49,52,9070,2640,565,39,6,2,1919,28,21,3
2020-12-15T12:36:09.272102,52.530813333299996,13.370958333299999, none, n,0.0037254313710444,29,49,53,9070,2655,580,37,6,2,1919,29,20,4
2020-12-15T12:36:10.293053,52.5307883333,13.37098, none, n,0.0037254313710444,30,52,54,9288,2823,600,37,4,0,1919,30,22,2
2020-12-15T12:36:11.309670,52.5307533333,13.3709966667, none, n,0.0037254313710444,30,52,54,9288,2823,600,37,4,0,1919,30,22,2
2020-12-15T12:36:12.314282,52.5307166667,13.37101, none, ne,0.003630336373198,31,52,56,9491,2855,615,35,6,2,1919,31,21,4
2020-12-15T12:36:13.337456,52.5306616667,13.371020000000001, none, ne,0.003630336373198,31,52,56,9491,2855,615,35,6,2,1919,31,21,4
2020-12-15T12:36:14.351289,52.5306216667,13.371039999999999, none, ne,0.003630336373198,31,50,54,9279,2830,595,33,6,2,1919,31,19,4
2020-12-15T12:36:15.372145,52.53058000000001,13.371058333299999, none, ne,0.003630336373198,31,50,54,9279,2830,595,33,6,2,1919,31,19,4
2020-12-15T12:36:16.380590,52.5305433333,13.3710816667, none, ne,0.003630336373198,30,48,52,8965,2650,573,33,6,2,1919,30,18,4
2020-12-15T12:36:17.404103,52.5305033333,13.371103333299999, none, ne,0.003630336373198,30,48,52,8965,2650,573,33,6,2,1919,30,18,4
2020-12-15T12:36:18.421949,52.5304633333,13.371125, none, ne,0.003630336373198,29,47,52,8559,2610,568,33,8,2,1919,29,18,5
2020-12-15T12:36:19.444748,52.5304416667,13.37116, none, ne,0.003630336373198,29,47,52,8559,2610,568,33,8,2,1919,29,18,5
2020-12-15T12:36:20.443026,52.5304133333,13.371196666700001, none, ne,0.0051450219905969,27,46,50,8529,2595,558,31,6,2,1919,27,19,4
2020-12-15T12:36:21.472128,52.53038000000001,13.371229999999999, none, ne,0.0051450219905969,29,43,48,8484,2585,556,18,8,2,1919,29,14,5
2020-12-15T12:36:22.493851,52.5303483333,13.371260000000001, none, ne,0.0051450219905969,26,39,45,7961,2375,526,14,8,2,1919,26,13,6
2020-12-15T12:36:23.510907,52.5303166667,13.37129, none, ne,0.0051450219905969,25,38,45,7534,2328,529,18,10,2,1919,25,13,7
2020-12-15T12:36:25.527413,52.5302116667,13.371375, none, ne,0.0051450219905969,25,39,45,7543,2318,514,23,8,2,1919,25,14,6
2020-12-15T12:36:26.544306,52.5301816667,13.371398333299998, none, ne,0.0051450219905969,24,38,44,7498,2172,371,21,8,2,1919,24,14,6
2020-12-15T12:36:27.560865,52.5301583333,13.371414999999999, none, ne,0.0051450219905969,23,37,43,7238,2133,351,26,10,2,1919,23,14,6
2020-12-15T12:36:28.580744,52.5301333333,13.371441666700001, none, ne,0.0050386758701811,21,37,43,6781,2071,353,30,10,2,1919,21,16,6
2020-12-15T12:36:29.597016,52.5301016667,13.37146, none, ne,0.0050386758701811,21,36,42,6697,1911,348,30,10,2,1919,21,15,6
2020-12-15T12:36:30.614464,52.5300783333,13.371488333299999, none, ne,0.0050386758701811,21,34,40,6470,1884,343,30,8,2,1919,21,13,6
2020-12-15T12:36:31.631191,52.530055000000004,13.371525, none, ne,0.0050386758701811,21,37,42,6521,1897,355,30,8,2,1919,21,16,5
2020-12-15T12:36:32.648464,52.5300316667,13.3715633333, none, ne,0.0050386758701811,20,35,39,6177,1828,325,28,6,2,1919,20,15,4
2020-12-15T12:36:33.665963,52.530006666700004,13.3715983333, none, ne,0.0050386758701811,19,35,39,6183,1823,335,28,6,2,1919,19,16,4
2020-12-15T12:36:34.682349,52.5299716667,13.37163, none, ne,0.0050386758701811,19,34,38,6183,1823,335,28,6,2,1919,19,15,4
2020-12-15T12:36:35.699593,52.529934999999995,13.371665, none, ne,0.0050386758701811,20,33,37,6192,1830,327,26,6,4,1919,20,13,4
2020-12-15T12:36:36.716620,52.529885,13.3716983333, none, ne,0.0046597506062935,20,33,37,6192,1830,327,26,6,4,1919,20,13,4
2020-12-15T12:36:37.734060,52.5298516667,13.37173, none, ne,0.0046597506062935,19,31,35,5908,1660,317,19,6,4,1919,19,12,4
2020-12-15T12:36:38.751448,52.5298233333,13.371766666700001, none, ne,0.0046597506062935,19,31,35,5908,1660,317,19,6,4,1919,19,12,4
2020-12-15T12:36:39.768471,52.5297916667,13.371801666700001, none, ne,0.0046597506062935,18,29,34,5699,1623,305,17,6,4,1919,18,11,5
2020-12-15T12:36:40.785206,52.5297633333,13.3718366667, none, ne,0.0046597506062935,18,29,34,5699,1623,305,17,6,4,1919,18,11,5
2020-12-15T12:36:41.802041,52.5297283333,13.371868333299998, none, ne,0.0046597506062935,18,30,31,5705,1620,320,12,2,2,1919,18,12,1
2020-12-15T12:36:42.819189,52.5296933333,13.371901666700001, none, ne,0.0046597506062935,18,30,31,5705,1620,320,12,2,2,1919,18,12,1
2020-12-15T12:36:43.822636,52.5296583333,13.371935, none, ne,0.0046597506062935,19,29,36,5923,1648,325,15,9,6,1919,19,10,7
2020-12-15T12:36:44.831535,52.529625,13.3719666667, none, ne,0.0048766571345415,19,29,36,5923,1648,325,15,9,6,1919,19,10,7
2020-12-15T12:36:45.852480,52.5296116667,13.372, none, ne,0.0048766571345415,18,29,35,5759,1648,325,15,9,6,1919,18,11,6
2020-12-15T12:36:46.872671,52.5296066667,13.372031666700002, none, ne,0.0048766571345415,18,29,35,5759,1648,325,15,9,6,1919,18,11,6
2020-12-15T12:36:47.893980,52.52959,13.372065, none, ne,0.0048766571345415,18,28,34,5747,1638,322,13,9,6,1919,18,10,6
2020-12-15T12:36:48.910296,52.5295666667,13.372091666700001, none, ne,0.0048766571345415,18,28,34,5747,1638,322,13,9,6,1919,18,10,6
2020-12-15T12:36:49.928066,52.5295466667,13.37212, none, ne,0.0048766571345415,18,28,34,5890,1645,315,13,9,6,1919,18,10,6
2020-12-15T12:36:50.944914,52.5295266667,13.372145000000002, none, ne,0.0048766571345415,18,28,34,5890,1645,315,13,9,6,1919,18,10,6
2020-12-15T12:36:51.960882,52.52950500000001,13.37217, none, ne,0.0048766571345415,18,29,36,5995,1813,330,13,11,6,1919,18,11,7
2020-12-15T12:36:52.976808,52.5294833333,13.3721966667, none, ne,0.0031629854336748,18,29,36,5995,1813,330,13,11,6,1919,18,11,7
2020-12-15T12:36:53.995098,52.52946,13.372225, none, ne,0.0031629854336748,20,33,40,6437,1890,350,20,11,6,1919,20,13,7
2020-12-15T12:36:55.009911,52.5294283333,13.3722566667, none, ne,0.0031629854336748,20,33,39,6452,1893,358,18,9,4,1919,20,13,6
2020-12-15T12:36:56.025971,52.5293966667,13.372279999999998, none, ne,0.0031629854336748,19,33,39,6428,1885,361,18,9,4,1919,19,14,6
2020-12-15T12:36:57.042322,52.52936,13.3722966667, none, ne,0.0031629854336748,18,32,38,5983,1835,358,20,9,4,1919,18,14,6
2020-12-15T12:36:58.059640,52.529334999999996,13.372321666700001, none, ne,0.0031629854336748,18,30,37,5908,1810,348,20,11,4,1919,18,12,7
2020-12-15T12:36:59.075155,52.5293016667,13.3723483333, none, ne,0.0031629854336748,18,31,34,5750,1807,346,17,6,0,1919,18,13,3
2020-12-15T12:37:00.091800,52.52926,13.372375, none, ne,0.0039440784611576,18,33,38,5989,1836,361,29,8,2,1919,18,15,5
2020-12-15T12:37:01.115090,52.529215,13.3723983333, none, ne,0.0039440784611576,20,36,42,6467,1916,527,31,8,2,1919,20,16,6
2020-12-15T12:37:02.117236,52.5291833333,13.372423333299999, none, ne,0.0039440784611576,20,38,45,6691,2071,542,35,10,2,1919,20,18,7
2020-12-15T12:37:03.139315,52.5291533333,13.3724516667, none, ne,0.0039440784611576,20,38,44,6727,2071,539,35,8,2,1919,20,18,6
2020-12-15T12:37:04.155425,52.5291216667,13.3724833333, none, ne,0.0039440784611576,21,40,44,6736,2069,537,37,8,2,1919,21,19,4
2020-12-15T12:37:05.173717,52.5290766667,13.372508333299999, none, ne,0.0039440784611576,20,38,45,6691,1916,529,39,10,4,1919,20,18,7
2020-12-15T12:37:06.187253,52.52904,13.3725383333, none, ne,0.0039440784611576,20,38,45,6715,2057,524,41,10,4,1919,20,18,7
2020-12-15T12:37:07.212259,52.5289933333,13.372568333299998, none, ne,0.0039440784611576,20,38,45,6715,2057,524,41,10,4,1919,20,18,7
2020-12-15T12:37:08.232001,52.5289433333,13.372603333299999, none, ne,0.0054929362424531,21,41,49,7202,2125,534,43,14,4,1919,21,20,8
2020-12-15T12:37:09.253683,52.528915000000005,13.3726366667, none, ne,0.0054929362424531,21,41,49,7202,2125,534,43,14,4,1919,21,20,8
2020-12-15T12:37:10.269991,52.5288966667,13.372675, none, ne,0.0054929362424531,23,42,51,7683,2323,542,43,14,4,1919,23,19,9
2020-12-15T12:37:11.286264,52.5288583333,13.372698333299999, none, ne,0.0054929362424531,23,42,51,7683,2323,542,43,14,4,1919,23,19,9
2020-12-15T12:37:12.302557,52.5288183333,13.372720000000001, none, ne,0.0054929362424531,24,43,52,7961,2368,534,41,14,4,1919,24,19,9
2020-12-15T12:37:13.319608,52.528765,13.372735, none, ne,0.0054929362424531,24,43,52,7961,2368,534,41,14,4,1919,24,19,9
2020-12-15T12:37:14.338224,52.5287116667,13.372751666700001, none, ne,0.0054929362424531,25,43,50,7985,2371,544,33,12,2,1919,25,18,7
2020-12-15T12:37:15.340797,52.5286666667,13.372765, none, ne,0.0054929362424531,25,43,50,7985,2371,544,33,12,2,1919,25,18,7
2020-12-15T12:37:16.360719,52.52863000000001,13.372779999999999, none, ne,0.0052619881262066,24,42,49,7746,2326,516,38,12,2,1919,24,18,7
2020-12-15T12:37:17.384425,52.5285916667,13.372795000000002, none, ne,0.0052619881262066,24,42,49,7746,2326,516,38,12,2,1919,24,18,7
2020-12-15T12:37:18.402052,52.52855,13.3728083333, none, ne,0.0052619881262066,23,40,48,7701,2321,523,36,12,2,1919,23,17,8
2020-12-15T12:37:19.418874,52.5285033333,13.3728233333, none, ne,0.0052619881262066,23,40,48,7701,2321,523,36,12,2,1919,23,17,8
2020-12-15T12:37:20.435222,52.5284916667,13.372855, none, ne,0.0052619881262066,23,40,48,7507,2175,516,34,12,2,1919,23,17,8
2020-12-15T12:37:21.452184,52.5284866667,13.37289, none, ne,0.0052619881262066,23,40,48,7507,2175,516,34,12,2,1919,23,17,8
2020-12-15T12:37:22.469071,52.528484999999996,13.372926666700002, none, ne,0.0052619881262066,21,36,44,7020,2090,363,25,12,2,1919,21,15,8
2020-12-15T12:37:23.485551,52.5284783333,13.3729616667, none, ne,0.0052619881262066,21,36,44,7020,2090,363,25,12,2,1919,21,15,8
2020-12-15T12:37:24.503409,52.528461666700004,13.3729916667, none, ne,0.0033666469266631,23,38,45,7453,2162,519,25,12,0,1919,23,15,7
2020-12-15T12:37:25.520297,52.5284383333,13.3730183333, none, ne,0.0033666469266631,23,41,47,7707,2322,541,27,12,0,1919,23,18,6
2020-12-15T12:37:27.539186,52.5283683333,13.373104999999999, none, ne,0.0033666469266631,25,42,46,7940,2359,546,23,8,0,1919,25,17,4
2020-12-15T12:37:28.555552,52.5283483333,13.373133333299998, none, ne,0.0033666469266631,23,41,45,7549,2309,543,23,8,0,1919,23,18,4
2020-12-15T12:37:29.571332,52.528330000000004,13.3731583333, none, ne,0.0033666469266631,23,43,46,7534,2309,556,30,6,0,1919,23,20,3
2020-12-15T12:37:30.593988,52.528305,13.3731816667, none, ne,0.0033666469266631,23,43,47,7549,2316,553,26,6,0,1919,23,20,4
2020-12-15T12:37:31.611822,52.5282833333,13.373204999999999, none, ne,0.0033666469266631,24,45,48,7767,2351,563,28,6,0,1919,24,21,3
2020-12-15T12:37:32.629350,52.528255,13.37323, none, ne,0.0040102811278645,24,45,49,7970,2369,563,28,6,0,1919,24,21,4
2020-12-15T12:37:33.647440,52.5282266667,13.373254999999999, none, ne,0.0040102811278645,24,46,49,8021,2384,575,28,6,0,1919,24,22,3
2020-12-15T12:37:34.672006,52.528195,13.3732766667, none, ne,0.0040102811278645,25,48,53,8236,2417,610,32,6,0,1919,25,23,5
2020-12-15T12:37:35.695141,52.528169999999996,13.3732983333, none, ne,0.0040102811278645,25,48,50,8236,2407,597,32,4,0,1919,25,23,2
2020-12-15T12:37:36.712049,52.528144999999995,13.3733216667, none, ne,0.0040102811278645,27,48,53,8490,2575,600,30,6,0,1919,27,21,5
2020-12-15T12:37:37.734905,52.5281166667,13.3733433333, none, ne,0.0040102811278645,25,49,55,8454,2570,600,34,8,0,1919,25,24,6
2020-12-15T12:37:38.746487,52.5280883333,13.3733666667, none, ne,0.0040102811278645,25,49,55,8454,2570,600,34,8,0,1919,25,24,6
2020-12-15T12:37:39.772075,52.5280516667,13.373385, none, ne,0.0040102811278645,26,52,55,8505,2590,603,36,6,0,1919,26,26,3
2020-12-15T12:37:40.792935,52.528009999999995,13.373395, none, ne,0.004205808417103,26,52,55,8505,2590,603,36,6,0,1919,26,26,3
2020-12-15T12:37:41.812799,52.527969999999996,13.373403333299999, none, ne,0.004205808417103,26,47,53,8272,2420,590,29,8,0,1919,26,21,6
2020-12-15T12:37:42.828770,52.52794,13.3734166667, none, ne,0.004205808417103,26,47,53,8242,2415,590,31,10,0,1919,26,21,6
2020-12-15T12:37:43.845259,52.5279133333,13.3734316667, none, ne,0.004205808417103,25,44,50,8212,2387,585,24,10,0,1919,25,19,6
2020-12-15T12:37:44.862351,52.5278866667,13.3734433333, none, ne,0.004205808417103,27,46,50,8484,2560,585,26,8,0,1919,27,19,4
2020-12-15T12:37:45.882565,52.5278633333,13.373456666700001, none, ne,0.004205808417103,27,47,51,8559,2577,580,28,8,0,1919,27,20,4
2020-12-15T12:37:46.904418,52.527840000000005,13.373470000000001, none, ne,0.004205808417103,28,46,50,8822,2619,555,24,8,0,1919,28,18,4
2020-12-15T12:37:47.921094,52.5278183333,13.3734833333, none, ne,0.004205808417103,28,47,53,8831,2629,558,29,8,0,1919,28,19,6
2020-12-15T12:37:48.934670,52.5277966667,13.373496666700001, none, ne,0.0035283583445805,28,47,50,8711,2596,553,29,6,0,1919,28,19,3
2020-12-15T12:37:49.951145,52.5277716667,13.3735116667, none, ne,0.0035283583445805,27,45,47,8502,2428,553,25,4,0,1919,27,18,2
2020-12-15T12:37:50.967406,52.5277516667,13.3735283333, none, ne,0.0035283583445805,27,44,46,8457,2413,555,25,4,0,1919,27,17,2
2020-12-15T12:37:51.983184,52.5277383333,13.373546666700001, none, ne,0.0035283583445805,27,45,46,8463,2423,568,25,2,0,1919,27,18,1
2020-12-15T12:37:52.999984,52.5277183333,13.37357, none, ne,0.0035283583445805,25,45,45,8296,2403,568,25,0,0,1919,25,20,0
2020-12-15T12:37:54.017838,52.5276916667,13.373591666700001, none, ne,0.0035283583445805,24,46,46,8039,2376,586,32,0,0,1919,24,22,0
2020-12-15T12:37:55.032270,52.5276766667,13.3736216667, none, ne,0.0035283583445805,22,42,42,7438,2138,569,28,0,0,1919,22,20,0
2020-12-15T12:37:56.048253,52.527584999999995,13.373615, none, ne,0.0035514803765694,21,40,40,7011,2091,559,28,0,0,1919,21,19,0
2020-12-15T12:37:57.064238,52.5276183333,13.373660000000001, none, ne,0.0035514803765694,21,41,41,7011,2091,559,28,0,0,1919,21,20,0
2020-12-15T12:37:58.080545,52.5276616667,13.3737066667, none, ne,0.0035514803765694,19,39,39,6449,1876,549,32,0,0,1919,19,20,0
2020-12-15T12:37:59.097570,52.527703333299996,13.37375, none, ne,0.0035514803765694,19,39,39,6449,1876,549,32,0,0,1919,19,20,0
2020-12-15T12:38:00.124419,52.527744999999996,13.3738, none, ne,0.0035514803765694,17,34,34,5690,1631,526,29,0,0,1919,17,17,0
2020-12-15T12:38:01.142176,52.527795,13.37385, none, ne,0.0035514803765694,17,34,34,5690,1631,526,29,0,0,1919,17,17,0
2020-12-15T12:38:02.164353,52.5278483333,13.3738983333, none, ne,0.0035514803765694,16,33,33,5445,1594,513,27,0,0,1919,16,17,0
2020-12-15T12:38:03.182029,52.5278966667,13.37394, none, ne,0.0035514803765694,16,33,33,5445,1594,513,27,0,0,1919,16,17,0
2020-12-15T12:38:04.197900,52.5279416667,13.3739816667, none, se,0.0066825114105452,16,32,32,5376,1572,363,27,0,0,1919,16,16,0
2020-12-15T12:38:05.212860,52.5279866667,13.374025, none, se,0.0066825114105452,16,32,32,5376,1572,363,27,0,0,1919,16,16,0
2020-12-15T12:38:06.228404,52.5280266667,13.374061666700001, none, se,0.0066825114105452,16,32,32,5227,1570,363,25,0,0,1919,16,16,0
2020-12-15T12:38:07.243714,52.5280616667,13.3740933333, none, se,0.0066825114105452,16,32,32,5191,1552,355,25,0,0,1919,16,16,0
2020-12-15T12:38:08.259265,52.528085,13.374118333299998, none, se,0.0066825114105452,15,30,30,4976,1400,333,23,0,0,1919,15,15,0
2020-12-15T12:38:09.277134,52.5280966667,13.3741283333, none, se,0.0066825114105452,16,31,31,5194,1548,325,26,0,0,1919,16,15,0
2020-12-15T12:38:10.288690,52.5281,13.37413, none, se,0.0066825114105452,16,32,33,5463,1583,325,28,2,0,1919,16,16,1
2020-12-15T12:38:11.313104,52.5280983333,13.3741316667, none, se,0.0066825114105452,17,33,35,5717,1625,343,28,4,0,1919,17,16,2
2020-12-15T12:38:12.333488,52.5280933333,13.3741333333, none, se,0.0028200868041573,18,35,38,5995,1798,355,28,4,0,1919,18,17,3
2020-12-15T12:38:13.350109,52.5280883333,13.3741333333, none, se,0.0028200868041573,19,36,40,6476,1865,370,28,6,0,1919,19,17,4
2020-12-15T12:38:14.366998,52.52808,13.3741366667, none, se,0.0028200868041573,19,36,41,6664,1875,370,28,6,0,1919,19,17,5
2020-12-15T12:38:15.382991,52.52806999999999,13.3741383333, none, se,0.0028200868041573,20,40,45,6760,1917,520,32,8,2,1919,20,20,5
2020-12-15T12:38:16.401235,52.5280666667,13.3741416667, none, se,0.0028200868041573,21,38,43,6963,2064,380,30,8,2,1919,21,17,5
2020-12-15T12:38:17.418652,52.5280766667,13.374148333299999, none, se,0.0028200868041573,21,39,45,7008,2074,383,35,10,2,1919,21,18,6
2020-12-15T12:38:18.438952,52.5280916667,13.374154999999998, none, se,0.0028200868041573,21,41,49,7283,2121,523,39,12,4,1919,21,20,8
2020-12-15T12:38:19.454068,52.5281083333,13.374158333299999, none, se,0.0028200868041573,21,41,49,7283,2121,523,39,12,4,1919,21,20,8
2020-12-15T12:38:20.473317,52.5281166667,13.37416, none, se,0.000451439501818,21,38,46,7193,2106,383,27,12,4,1919,21,17,8
2020-12-15T12:38:21.490615,52.5281166667,13.374158333299999, none, se,0.000451439501818,21,38,46,7193,2106,383,27,12,4,1919,21,17,8
2020-12-15T12:38:22.508437,52.5281183333,13.374156666700001, none, se,0.000451439501818,21,39,45,7208,2121,518,25,10,4,1919,21,18,6
2020-12-15T12:38:24.525500,52.5281683333,13.374163333299999, none, se,0.000451439501818,21,39,45,7208,2121,518,25,10,4,1919,21,18,6
2020-12-15T12:38:25.543583,52.52819,13.374161666700001, none, se,0.000451439501818,21,39,44,7008,2099,528,25,8,4,1919,21,18,5
2020-12-15T12:38:26.561339,52.5282116667,13.3741666667, none, se,0.000451439501818,21,39,44,7008,2099,528,25,8,4,1919,21,18,5
2020-12-15T12:38:27.576536,52.5282033333,13.3741683333, none, se,0.000451439501818,20,38,44,6942,2074,541,23,8,4,1919,20,18,6
2020-12-15T12:38:28.593366,52.5282,13.3741683333, none, s,0.0013261848046535,20,38,44,6942,2074,541,23,8,4,1919,20,18,6
2020-12-15T12:38:29.610518,52.5282016667,13.3741683333, none, s,0.0013261848046535,21,39,46,7190,2111,556,23,10,6,1919,21,18,7
2020-12-15T12:38:30.631242,52.5282133333,13.3741716667, none, s,0.0013261848046535,21,39,46,7190,2111,556,23,10,6,1919,21,18,7
2020-12-15T12:38:31.648990,52.528215,13.3741716667, none, s,0.0013261848046535,21,40,49,7211,2129,559,27,12,8,1919,21,19,9
2020-12-15T12:38:32.666057,52.528215,13.3741716667, none, s,0.0013261848046535,21,40,49,7211,2129,559,27,12,8,1919,21,19,9
2020-12-15T12:38:33.681896,52.5282133333,13.374170000000001, none, s,0.0013261848046535,21,39,46,6981,2097,554,23,10,6,1919,21,18,7
2020-12-15T12:38:34.703060,52.528195,13.374163333299999, none, s,0.0013261848046535,21,39,46,6981,2097,554,23,10,6,1919,21,18,7
2020-12-15T12:38:35.719793,52.5281666667,13.374158333299999, none, s,0.0013261848046535,20,39,45,6915,2080,554,23,10,6,1919,20,19,6
2020-12-15T12:38:36.736804,52.52814,13.374153333299999, none, n,0.00096406058400391,20,39,45,6915,2080,554,23,10,6,1919,20,19,6
2020-12-15T12:38:37.753727,52.5281116667,13.374148333299999, none, n,0.00096406058400391,20,36,43,6712,2055,546,18,8,6,1919,20,16,7
2020-12-15T12:38:38.772885,52.5280966667,13.374148333299999, none, n,0.00096406058400391,20,37,43,6712,2055,546,18,8,6,1919,20,17,6
2020-12-15T12:38:39.790664,52.5280983333,13.37415, none, n,0.00096406058400391,19,34,39,6407,1872,529,14,6,4,1919,19,15,5
2020-12-15T12:38:40.808299,52.5281216667,13.374156666700001, none, n,0.00096406058400391,19,34,39,6407,1872,529,14,6,4,1919,19,15,5
2020-12-15T12:38:41.833024,52.5281483333,13.374163333299999, none, n,0.00096406058400391,19,33,39,6192,1842,521,14,6,4,1919,19,14,6
2020-12-15T12:38:42.850035,52.5281766667,13.374170000000001, none, n,0.00096406058400391,19,33,39,6192,1842,521,14,6,4,1919,19,14,6
2020-12-15T12:38:43.853410,52.5282033333,13.374175, none, n,0.00096406058400391,18,33,38,6013,1810,521,14,6,4,1919,18,15,5
2020-12-15T12:38:44.876613,52.5282316667,13.3741816667, none, s,0.0014815717707753,18,33,38,6013,1810,521,14,6,4,1919,18,15,5
2020-12-15T12:38:45.894468,52.52823000000001,13.3741816667, none, s,0.0014815717707753,18,33,39,6252,1835,513,14,6,4,1919,18,15,6
2020-12-15T12:38:46.913228,52.52823000000001,13.3741816667, none, s,0.0014815717707753,19,32,36,6401,1837,367,12,6,4,1919,19,13,4
2020-12-15T12:38:47.929669,52.52823000000001,13.3741816667, none, s,0.0014815717707753,18,31,33,5995,1793,352,10,2,2,1919,18,13,2
2020-12-15T12:38:48.946127,52.52823000000001,13.3741816667, none, s,0.0014815717707753,18,31,31,6010,1793,352,6,0,0,1919,18,13,0
2020-12-15T12:38:49.962699,52.52823000000001,13.3741816667, none, s,0.0014815717707753,19,32,33,6452,1840,355,10,2,0,1919,19,13,1
2020-12-15T12:38:50.979177,52.52823000000001,13.3741816667, none, s,0.0014815717707753,19,32,33,6509,1852,352,10,2,0,1919,19,13,1
2020-12-15T12:38:51.995324,52.5282383333,13.3741833333, none, s,0.0014815717707753,20,33,36,6703,1887,360,10,4,2,1919,20,13,3
2020-12-15T12:38:53.013332,52.5282416667,13.3741833333, none, s,0.0001598958079874,20,34,39,6709,1887,375,14,6,2,1919,20,14,5
2020-12-15T12:38:54.020762,52.5282366667,13.3741833333, none, s,0.0001598958079874,20,35,42,6739,1895,375,21,10,4,1919,20,15,7
2020-12-15T12:38:55.041571,52.5282333333,13.3741833333, none, s,0.0001598958079874,20,36,43,6694,1905,373,25,10,4,1919,20,16,7
2020-12-15T12:38:56.057324,52.528225,13.374185, none, s,0.0001598958079874,20,35,43,6461,1885,371,25,10,4,1919,20,15,8
2020-12-15T12:38:57.073842,52.5282233333,13.3741833333, none, s,0.0001598958079874,20,35,43,6461,1885,366,27,10,4,1919,20,15,8
2020-12-15T12:38:58.090233,52.52822,13.3741833333, none, s,0.0001598958079874,20,35,42,6491,1900,361,25,10,4,1919,20,15,7
2020-12-15T12:38:59.113558,52.528218333299996,13.3741833333, none, s,0.0001598958079874,20,35,42,6491,1900,361,25,10,4,1919,20,15,7
2020-12-15T12:39:00.127132,52.528215,13.374185, none, n,0.00042369621724062,21,38,44,6739,2067,516,27,10,4,1919,21,17,6
2020-12-15T12:39:01.151554,52.5282133333,13.374185, none, n,0.00042369621724062,20,37,42,6470,1897,383,25,8,4,1919,20,17,5
2020-12-15T12:39:02.168105,52.528209999999994,13.3741866667, none, n,0.00042369621724062,20,38,43,6449,1900,516,25,8,4,1919,20,18,5
2020-12-15T12:39:03.183683,52.5282016667,13.374198333299999, none, n,0.00042369621724062,19,36,42,6210,1863,513,30,8,2,1919,19,17,6
2020-12-15T12:39:04.199859,52.528185,13.374213333299998, none, n,0.00042369621724062,20,38,43,6473,1895,515,28,8,2,1919,20,18,5
2020-12-15T12:39:05.218510,52.528165,13.3742266667, none, n,0.00042369621724062,20,37,39,6494,1887,513,21,4,0,1919,20,17,2
2020-12-15T12:39:06.233304,52.5281566667,13.374235, none, n,0.00042369621724062,20,37,39,6658,1889,513,19,4,0,1919,20,17,2
2020-12-15T12:39:07.252160,52.5281433333,13.374246666700001, none, n,0.00042369621724062,20,36,38,6703,1894,377,19,4,0,1919,20,16,2
2020-12-15T12:39:08.275598,52.528128333299996,13.374253333299999, none, ne,0.0015268756240105,20,37,40,6748,1912,380,19,6,0,1919,20,17,3
2020-12-15T12:39:09.291994,52.52811,13.3742733333, none, ne,0.0015268756240105,20,35,40,6718,1897,378,21,6,0,1919,20,15,5
2020-12-15T12:39:10.307985,52.5281066667,13.3743133333, none, ne,0.0015268756240105,18,34,39,6231,1825,348,26,8,0,1919,18,16,5
2020-12-15T12:39:11.323859,52.5281116667,13.3743633333, none, ne,0.0015268756240105,19,35,41,6461,1864,358,28,10,0,1919,19,16,6
2020-12-15T12:39:12.340452,52.528128333299996,13.374414999999999, none, ne,0.0015268756240105,19,36,41,6506,1866,356,30,10,0,1919,19,17,5
2020-12-15T12:39:13.357852,52.5281516667,13.37447, none, ne,0.0015268756240105,19,36,41,6506,1866,356,30,10,0,1919,19,17,5
2020-12-15T12:39:14.374317,52.5281766667,13.374526666700001, none, ne,0.0015268756240105,20,34,40,6769,1898,349,23,8,0,1919,20,14,6
2020-12-15T12:39:15.390799,52.5282,13.3745866667, none, ne,0.0015268756240105,20,34,40,6769,1898,349,23,8,0,1919,20,14,6
2020-12-15T12:39:16.407971,52.528225,13.3746516667, none, e,0.0041444627382528,20,34,38,6688,1886,347,21,6,0,1919,20,14,4
2020-12-15T12:39:17.424696,52.5282483333,13.374716666700001, none, e,0.0041444627382528,20,34,38,6688,1886,347,21,6,0,1919,20,14,4
2020-12-15T12:39:18.441883,52.5282733333,13.3747816667, none, e,0.0041444627382528,20,36,40,6769,2059,367,21,6,0,1919,20,16,4
2020-12-15T12:39:19.459493,52.5282983333,13.3748466667, none, e,0.0041444627382528,20,37,40,6769,2059,367,21,6,0,1919,20,17,3
2020-12-15T12:39:20.475826,52.5283233333,13.374911666700001, none, e,0.0041444627382528,20,37,40,6742,2057,367,19,6,0,1919,20,17,3
2020-12-15T12:39:21.496701,52.5283466667,13.374975, none, e,0.0041444627382528,20,37,40,6742,2057,367,19,6,0,1919,20,17,3
2020-12-15T12:39:22.512742,52.528369999999995,13.3750383333, none, e,0.0041444627382528,21,36,41,6772,2069,367,17,6,0,1919,21,15,5
2020-12-15T12:39:24.530274,52.5284366667,13.3752216667, none, e,0.0064535485126482,21,36,41,6772,2069,367,17,6,0,1919,21,15,5
2020-12-15T12:39:25.546721,52.528459999999995,13.375283333299999, none, e,0.0064535485126482,20,36,39,6712,2054,377,17,4,0,1919,20,16,3
2020-12-15T12:39:26.563473,52.5284833333,13.3753433333, none, e,0.0064535485126482,20,37,39,6712,2054,377,17,4,0,1919,20,17,2
2020-12-15T12:39:27.580304,52.528505,13.375404999999999, none, e,0.0064535485126482,21,39,42,7035,2108,532,19,6,0,1919,21,18,3
2020-12-15T12:39:28.596873,52.5285266667,13.375468333299999, none, e,0.0064535485126482,22,39,42,7507,2160,525,16,4,0,1919,22,17,3
2020-12-15T12:39:29.613678,52.52855,13.37553, none, e,0.0064535485126482,23,39,40,7546,2173,512,12,2,0,1919,23,16,1
2020-12-15T12:39:30.630352,52.5285733333,13.3755933333, none, e,0.0064535485126482,24,39,40,7689,2306,519,10,2,0,1919,24,15,1
2020-12-15T12:39:31.647346,52.528596666700004,13.375656666700001, none, e,0.0064535485126482,24,41,42,7725,2323,536,14,2,0,1919,24,17,1
2020-12-15T12:39:32.663943,52.5286216667,13.3757216667, none, e,0.0056554150600616,26,43,44,8024,2375,543,18,2,0,1919,26,17,1
2020-12-15T12:39:33.680644,52.528645,13.375786666700002, none, e,0.0056554150600616,26,43,44,8054,2382,533,22,2,0,1919,26,17,1
2020-12-15T12:39:34.698382,52.5286666667,13.375851666700001, none, e,0.0056554150600616,28,45,46,8571,2584,550,24,2,0,1919,28,17,1
2020-12-15T12:39:35.713725,52.528690000000005,13.3759166667, none, e,0.0056554150600616,27,44,47,8517,2570,540,26,4,0,1919,27,17,3
2020-12-15T12:39:36.730428,52.52871,13.375981666700001, none, e,0.0056554150600616,28,45,47,8825,2622,535,24,4,0,1919,28,17,2
2020-12-15T12:39:37.747087,52.5287283333,13.37605, none, e,0.0056554150600616,29,45,46,8998,2635,518,20,2,0,1919,29,16,1
2020-12-15T12:39:38.763794,52.5287466667,13.376116666700002, none, e,0.0056554150600616,28,45,46,8795,2620,538,18,2,0,1919,28,17,1
2020-12-15T12:39:39.782281,52.52876,13.376178333299999, none, e,0.0056554150600616,26,45,46,8556,2580,541,20,2,0,1919,26,19,1
2020-12-15T12:39:40.799568,52.5287716667,13.3762366667, none, e,0.0055178931012313,26,45,46,8556,2580,541,20,2,0,1919,26,19,1
2020-12-15T12:39:41.813162,52.5287866667,13.3762983333, none, e,0.0055178931012313,28,46,48,8735,2610,556,22,4,0,1919,28,18,2
2020-12-15T12:39:42.829412,52.5288033333,13.37636, none, e,0.0055178931012313,26,47,49,8750,2615,569,25,4,0,1919,26,21,2
2020-12-15T12:39:43.845335,52.528821666700004,13.3764233333, none, e,0.0055178931012313,27,48,50,8756,2623,584,21,4,0,1919,27,21,2
2020-12-15T12:39:44.862960,52.52884,13.376485, none, e,0.0055178931012313,27,48,50,8735,2616,584,17,4,0,1919,27,21,2
2020-12-15T12:39:45.878360,52.5288616667,13.376548333299999, none, e,0.0055178931012313,26,46,48,8254,2424,572,17,4,0,1919,26,20,2
2020-12-15T12:39:46.893971,52.528888333299996,13.3766133333, none, e,0.0055178931012313,26,48,49,8472,2581,587,19,2,0,1919,26,22,1
2020-12-15T12:39:47.910328,52.5289066667,13.3766733333, none, e,0.0055178931012313,26,48,49,8299,2563,587,21,2,0,1919,26,22,1
2020-12-15T12:39:48.926333,52.52891999999999,13.376735, none, e,0.0053613533553734,24,44,46,7961,2363,567,23,2,0,1919,24,20,2
2020-12-15T12:39:49.942826,52.528925,13.3767916667, none, e,0.0053613533553734,24,45,48,8006,2383,569,25,4,0,1919,24,21,3
2020-12-15T12:39:50.959473,52.5289383333,13.37685, none, e,0.0053613533553734,25,44,48,8006,2371,554,23,4,0,1919,25,19,4
2020-12-15T12:39:51.977218,52.5289566667,13.37691, none, e,0.0053613533553734,24,43,44,7767,2331,542,21,2,0,1919,24,19,1
2020-12-15T12:39:52.991480,52.528975,13.376973333299999, none, e,0.0053613533553734,22,40,43,7492,2149,517,21,4,0,1919,22,18,3
2020-12-15T12:39:54.012472,52.5289966667,13.3770366667, none, e,0.0053613533553734,21,38,41,7229,2099,369,23,6,0,1919,21,17,3
2020-12-15T12:39:55.029194,52.5290166667,13.3770983333, none, e,0.0053613533553734,21,38,41,7229,2099,369,23,6,0,1919,21,17,3
2020-12-15T12:39:56.043463,52.5290383333,13.377161666700001, none, e,0.0045314750351208,21,39,42,7259,2104,379,25,6,0,1919,21,18,3
2020-12-15T12:39:57.061938,52.5290616667,13.3772233333, none, e,0.0045314750351208,21,39,43,7462,2121,519,23,6,0,1919,21,18,4
2020-12-15T12:39:58.082496,52.529090000000004,13.3772883333, none, e,0.0045314750351208,22,38,43,7471,2119,522,21,8,0,1919,22,16,5
2020-12-15T12:39:59.105036,52.52911999999999,13.377355, none, e,0.0045314750351208,21,37,42,7247,2090,522,19,8,0,1919,21,16,5
2020-12-15T12:40:00.122043,52.5291483333,13.3774216667, none, e,0.0045314750351208,22,39,45,7450,2122,542,26,10,0,1919,22,17,6
2020-12-15T12:40:01.138606,52.5291733333,13.377486666700001, none, e,0.0045314750351208,22,40,45,7465,2127,547,26,10,0,1919,22,18,5
2020-12-15T12:40:02.154042,52.529194999999994,13.3775516667, none, e,0.0045314750351208,22,40,46,7477,2144,557,28,10,0,1919,22,18,6
2020-12-15T12:40:03.170190,52.529215,13.3776183333, none, e,0.0045314750351208,24,41,46,7528,2154,552,30,10,0,1919,24,17,5
2020-12-15T12:40:04.186139,52.5292333333,13.377685000000001, none, e,0.0059305996265364,24,40,45,7543,2171,552,25,8,0,1919,24,16,5
2020-12-15T12:40:05.202927,52.529248333299996,13.3777483333, none, e,0.0059305996265364,24,41,45,7710,2173,555,27,6,0,1919,24,17,4
2020-12-15T12:40:06.219158,52.529265,13.377808333299999, none, e,0.0059305996265364,22,40,43,7456,2138,537,25,6,0,1919,22,18,3
2020-12-15T12:40:07.235326,52.5292833333,13.377868333299999, none, e,0.0059305996265364,23,39,42,7447,2140,520,25,6,0,1919,23,16,3
2020-12-15T12:40:08.251843,52.5292983333,13.3779283333, none, e,0.0059305996265364,23,40,42,7289,2137,382,25,4,0,1919,23,17,2
2020-12-15T12:40:09.267637,52.5293166667,13.3779883333, none, e,0.0059305996265364,23,40,42,7289,2137,382,25,4,0,1919,23,17,2
2020-12-15T12:40:10.283434,52.529334999999996,13.378045000000002, none, e,0.0059305996265364,25,40,43,7468,2159,520,25,4,0,1919,25,15,3
2020-12-15T12:40:11.299615,52.5293516667,13.378103333299999, none, e,0.0059305996265364,25,40,43,7468,2159,520,25,4,0,1919,25,15,3
2020-12-15T12:40:12.315635,52.529385,13.378155, none, e,0.0051413742304503,25,39,42,7453,2154,382,18,4,2,1919,25,14,3
2020-12-15T12:40:13.331670,52.5293716667,13.3782283333, none, e,0.0051413742304503,25,39,42,7453,2154,382,18,4,2,1919,25,14,3
2020-12-15T12:40:14.348366,52.5293766667,13.378295000000001, none, e,0.0051413742304503,25,38,40,7468,2164,375,14,2,2,1919,25,13,2
2020-12-15T12:40:15.364958,52.5293966667,13.3783583333, none, e,0.0051413742304503,25,38,40,7468,2164,375,14,2,2,1919,25,13,2
2020-12-15T12:40:16.381444,52.529419999999995,13.378418333299999, none, e,0.0051413742304503,25,38,40,7528,2309,513,12,2,2,1919,25,13,2
2020-12-15T12:40:17.398517,52.5294433333,13.378478333299999, none, e,0.0051413742304503,25,38,40,7528,2309,513,12,2,2,1919,25,13,2
2020-12-15T12:40:18.415198,52.5294633333,13.37854, none, e,0.0051413742304503,24,37,39,7432,2159,382,10,2,2,1919,24,13,2
2020-12-15T12:40:19.432105,52.529485,13.378601666700002, none, e,0.0051413742304503,24,37,39,7432,2159,382,10,2,2,1919,24,13,2
2020-12-15T12:40:20.448840,52.5294983333,13.37866, none, e,0.0052016594869903,26,38,41,7701,2329,382,10,4,4,1919,26,12,3
2020-12-15T12:40:21.465734,52.529515,13.378720000000001, none, e,0.0052016594869903,26,38,41,7701,2329,382,10,4,4,1919,26,12,3
2020-12-15T12:40:22.482434,52.529536666700004,13.3787816667, none, e,0.0052016594869903,26,38,43,7534,2327,515,13,8,4,1919,26,12,5
2020-12-15T12:40:23.500048,52.529555,13.378843333299999, none, e,0.0052016594869903,26,38,43,7534,2327,515,13,8,4,1919,26,12,5
2020-12-15T12:40:24.516280,52.5295766667,13.378905, none, e,0.0052016594869903,26,39,44,7719,2349,523,17,8,4,1919,26,13,5
2020-12-15T12:40:26.532739,52.5296516667,13.3790966667, none, e,0.0052016594869903,26,39,44,7719,2349,523,17,8,4,1919,26,13,5
2020-12-15T12:40:27.549333,52.529675,13.37916, none, e,0.0052016594869903,26,39,45,7764,2359,530,17,8,4,1919,26,13,6
2020-12-15T12:40:28.566156,52.529695,13.379220000000002, none, e,0.0062486509140391,26,39,46,7764,2359,530,17,8,4,1919,26,13,7
2020-12-15T12:40:29.583049,52.529725,13.37928, none, e,0.0062486509140391,26,40,48,8027,2394,542,17,10,4,1919,26,14,8
2020-12-15T12:40:30.599468,52.5297483333,13.3793316667, none, e,0.0062486509140391,26,40,48,8027,2394,542,17,10,4,1919,26,14,8
2020-12-15T12:40:31.616281,52.529765000000005,13.3793766667, none, e,0.0062486509140391,26,42,49,8236,2419,534,19,10,4,1919,26,16,7
2020-12-15T12:40:32.632998,52.5297883333,13.379420000000001, none, e,0.0062486509140391,26,42,49,8236,2419,534,19,10,4,1919,26,16,7
2020-12-15T12:40:33.650716,52.529819999999994,13.379470000000001, none, e,0.0062486509140391,26,41,49,8057,2404,529,21,12,4,1919,26,15,8
2020-12-15T12:40:34.667648,52.529844999999995,13.3795216667, none, e,0.0062486509140391,26,41,50,8042,2394,531,25,14,4,1919,26,15,9
2020-12-15T12:40:35.684083,52.529869999999995,13.3795783333, none, e,0.0062486509140391,26,42,51,8027,2394,521,29,14,4,1919,26,16,9
2020-12-15T12:40:36.699831,52.5298916667,13.37964, none, se,0.0051218038111305,27,43,54,8251,2416,521,36,16,6,1919,27,16,11
2020-12-15T12:40:37.713827,52.529918333299996,13.3797, none, se,0.0051218038111305,26,43,52,8287,2414,531,34,14,4,1919,26,17,9
2020-12-15T12:40:38.733055,52.5299433333,13.3797616667, none, se,0.0051218038111305,26,42,49,8311,2404,518,29,10,4,1919,26,16,7
2020-12-15T12:40:39.750337,52.529963333299996,13.379821666700002, none, se,0.0051218038111305,26,41,48,8042,2355,380,27,10,4,1919,26,15,7
2020-12-15T12:40:40.767385,52.5299833333,13.379883333299999, none, se,0.0051218038111305,25,40,49,7767,2316,378,31,12,4,1919,25,15,9
2020-12-15T12:40:41.783788,52.530008333299996,13.379945000000001, none, se,0.0051218038111305,24,39,46,7519,2148,368,29,10,4,1919,24,15,7
2020-12-15T12:40:42.799789,52.5300316667,13.380004999999999, none, se,0.0051218038111305,24,37,43,7453,2116,368,27,10,4,1919,24,13,6
2020-12-15T12:40:43.816767,52.530055000000004,13.380066666700001, none, se,0.0051218038111305,24,37,43,7438,2106,368,25,8,4,1919,24,13,6
2020-12-15T12:40:44.834680,52.5300816667,13.38013, none, e,0.0056152361274564,23,36,41,7175,2067,351,25,6,4,1919,23,13,5
2020-12-15T12:40:45.850623,52.5301066667,13.3801933333, none, e,0.0056152361274564,21,35,39,6951,1900,353,23,6,4,1919,21,14,4
2020-12-15T12:40:46.868686,52.53013000000001,13.380254999999998, none, e,0.0056152361274564,21,35,39,6951,1900,353,23,6,4,1919,21,14,4
2020-12-15T12:40:47.883830,52.53015500000001,13.380315, none, e,0.0056152361274564,21,33,37,6960,1898,353,16,4,2,1919,21,12,4
2020-12-15T12:40:48.900610,52.5301816667,13.3803733333, none, e,0.0056152361274564,21,33,37,6960,1898,353,16,4,2,1919,21,12,4
2020-12-15T12:40:49.915709,52.530205,13.3804333333, none, e,0.0056152361274564,20,32,37,6661,1853,340,18,6,2,1919,20,12,5
2020-12-15T12:40:50.931987,52.5302266667,13.380493333299999, none, e,0.0056152361274564,20,32,37,6661,1853,340,18,6,2,1919,20,12,5
2020-12-15T12:40:51.955498,52.530253333299996,13.3805533333, none, e,0.0056152361274564,20,32,37,6479,1851,333,18,6,2,1919,20,12,5
2020-12-15T12:40:52.972229,52.530275,13.380614999999999, none, e,0.0056033658962003,20,32,37,6479,1851,333,18,6,2,1919,20,12,5
2020-12-15T12:40:53.991358,52.530294999999995,13.380675, none, e,0.0056033658962003,22,32,37,6936,1915,333,16,6,2,1919,22,10,5
2020-12-15T12:40:55.011731,52.5303133333,13.380731666700001, none, e,0.0056033658962003,22,32,37,6936,1915,333,16,6,2,1919,22,10,5
2020-12-15T12:40:56.034320,52.53034,13.380795, none, e,0.0056033658962003,23,33,37,7181,2080,333,12,4,2,1919,23,10,4
2020-12-15T12:40:57.049191,52.530359999999995,13.380854999999999, none, e,0.0056033658962003,23,33,37,7181,2080,333,12,4,2,1919,23,10,4
2020-12-15T12:40:58.065250,52.53038000000001,13.380911666700001, none, e,0.0056033658962003,22,33,35,6969,2058,336,12,4,2,1919,22,11,2
2020-12-15T12:40:59.080876,52.5304016667,13.3809716667, none, e,0.0056033658962003,23,34,36,6969,2058,336,12,4,2,1919,23,11,2
2020-12-15T12:41:00.098098,52.530425,13.3810316667, none, e,0.0046786591317793,24,36,41,7217,2112,349,16,8,2,1919,24,12,5
2020-12-15T12:41:01.114425,52.5304483333,13.381093333299999, none, e,0.0046786591317793,24,38,41,7471,2162,364,14,6,0,1919,24,14,3
2020-12-15T12:41:02.130610,52.5304633333,13.381153333299999, none, e,0.0046786591317793,25,38,41,7734,2319,369,10,6,0,1919,25,13,3
2020-12-15T12:41:03.146616,52.530478333299996,13.3812116667, none, e,0.0046786591317793,26,40,43,8018,2371,512,8,6,0,1919,26,14,3
2020-12-15T12:41:04.162878,52.530494999999995,13.38127, none, e,0.0046786591317793,26,42,45,8024,2383,522,10,6,0,1919,26,16,3
2020-12-15T12:41:05.180031,52.53051,13.381326666700001, none, e,0.0046786591317793,27,44,49,8475,2568,537,15,6,0,1919,27,17,5
2020-12-15T12:41:06.196261,52.5305266667,13.381386666700001, none, e,0.0046786591317793,28,45,50,8529,2595,552,15,6,0,1919,28,17,5
2020-12-15T12:41:07.212055,52.5305433333,13.381445000000001, none, e,0.0046786591317793,27,46,50,8544,2593,557,15,6,0,1919,27,19,4
2020-12-15T12:41:08.229166,52.530559999999994,13.3815033333, none, e,0.0050372154902156,26,44,49,8239,2410,549,15,6,0,1919,26,18,5
2020-12-15T12:41:09.244144,52.5305733333,13.381563333299999, none, e,0.0050372154902156,26,46,49,8227,2408,544,17,6,0,1919,26,20,3
2020-12-15T12:41:10.260371,52.5305833333,13.381620000000002, none, e,0.0050372154902156,26,47,48,8024,2386,554,22,2,0,1919,26,21,1
2020-12-15T12:41:11.276167,52.530595,13.38168, none, e,0.0050372154902156,25,46,47,7940,2361,544,24,2,0,1919,25,21,1
2020-12-15T12:41:12.291714,52.5306066667,13.3817416667, none, e,0.0050372154902156,24,44,46,7692,2319,536,24,2,0,1919,24,20,2
2020-12-15T12:41:13.311211,52.5306166667,13.381803333299999, none, e,0.0050372154902156,24,44,46,7692,2319,536,24,2,0,1919,24,20,2
2020-12-15T12:41:14.328203,52.5306233333,13.381865, none, e,0.0050372154902156,25,46,47,7761,2341,536,26,2,0,1919,25,21,1
2020-12-15T12:41:15.340531,52.5306283333,13.381925, none, e,0.0050372154902156,24,43,44,7516,2304,521,28,2,0,1919,24,19,1
2020-12-15T12:41:16.357657,52.530635,13.381979999999999, none, e,0.0047577955754385,24,42,42,7238,2132,514,25,0,0,1919,24,18,0
2020-12-15T12:41:17.374046,52.5306516667,13.382035, none, e,0.0047577955754385,23,43,43,7193,2110,524,30,0,0,1919,23,20,0
2020-12-15T12:41:18.390740,52.5306683333,13.382091666700001, none, e,0.0047577955754385,21,41,41,6766,2063,521,30,0,0,1919,21,20,0
2020-12-15T12:41:19.408000,52.5306783333,13.3821466667, none, e,0.0047577955754385,21,46,46,7268,2115,554,37,0,0,1919,21,25,0
2020-12-15T12:41:20.423610,52.5306883333,13.3821966667, none, e,0.0047577955754385,21,46,46,7274,2107,559,39,0,0,1919,21,25,0
2020-12-15T12:41:21.440121,52.5307083333,13.382245000000001, none, e,0.0047577955754385,21,43,43,7265,2092,546,34,0,0,1919,21,22,0
2020-12-15T12:41:22.456577,52.5307266667,13.3822883333, none, e,0.0047577955754385,20,42,42,7026,2050,543,32,0,0,1919,20,22,0
2020-12-15T12:41:23.475191,52.5307416667,13.3823316667, none, e,0.0047577955754385,21,42,42,7190,2075,556,32,0,0,1919,21,21,0
2020-12-15T12:41:24.490272,52.5307583333,13.382370000000002, none, e,0.0042475197185901,20,41,41,6754,1903,546,32,0,0,1919,20,21,0
2020-12-15T12:41:25.507880,52.53077,13.382404999999999, none, e,0.0042475197185901,20,42,42,7023,2068,569,32,0,0,1919,20,22,0
2020-12-15T12:41:27.524136,52.5308016667,13.382496666700002, none, e,0.0042475197185901,20,43,43,7017,2073,579,30,0,0,1919,20,23,0
2020-12-15T12:41:28.540813,52.530813333299996,13.382525, none, e,0.0042475197185901,20,43,43,7017,2073,579,30,0,0,1919,20,23,0
2020-12-15T12:41:29.559111,52.5308166667,13.382545, none, e,0.0042475197185901,21,41,41,7181,2085,559,23,0,0,1919,21,20,0
2020-12-15T12:41:30.575876,52.530825,13.3825666667, none, e,0.0042475197185901,21,41,41,7181,2085,559,23,0,0,1919,21,20,0
2020-12-15T12:41:31.592398,52.5308316667,13.382585, none, e,0.0042475197185901,22,42,45,7286,2119,572,30,4,2,1919,22,20,3
2020-12-15T12:41:32.608383,52.530834999999996,13.3826, none, e,0.0025343511874797,22,42,45,7286,2119,572,30,4,2,1919,22,20,3
2020-12-15T12:41:33.623325,52.5308416667,13.3826116667, none, e,0.0025343511874797,23,41,44,7038,2107,557,25,4,2,1919,23,18,3
2020-12-15T12:41:34.643685,52.5308483333,13.382620000000001, none, e,0.0025343511874797,23,41,44,7038,2107,557,25,4,2,1919,23,18,3
2020-12-15T12:41:35.660784,52.530856666700004,13.3826316667, none, e,0.0025343511874797,22,40,43,7002,2100,549,21,4,2,1919,22,18,3
2020-12-15T12:41:36.678405,52.530865000000006,13.382648333299999, none, e,0.0025343511874797,21,38,42,7017,2097,564,21,6,2,1919,21,17,4
2020-12-15T12:41:37.696613,52.5308733333,13.3826633333, none, e,0.0025343511874797,23,40,46,7429,2154,569,23,8,2,1919,23,17,6
2020-12-15T12:41:38.711950,52.5308833333,13.3826833333, none, e,0.0025343511874797,23,39,44,7190,2124,559,27,8,2,1919,23,16,5
2020-12-15T12:41:39.729077,52.5308966667,13.3827083333, none, e,0.0025343511874797,22,40,49,7459,2156,569,34,15,4,1919,22,18,9
2020-12-15T12:41:40.745842,52.5309083333,13.382735, none, se,0.0017489961745625,23,39,49,7480,2164,546,32,15,4,1919,23,16,10
2020-12-15T12:41:41.762501,52.530919999999995,13.382765, none, se,0.0017489961745625,23,39,48,7522,2169,533,32,15,4,1919,23,16,9
2020-12-15T12:41:42.779578,52.530925,13.382793333299999, none, se,0.0017489961745625,23,37,48,7435,2142,530,32,15,4,1919,23,14,11
2020-12-15T12:41:43.796449,52.5309233333,13.382825, none, se,0.0017489961745625,23,39,47,7253,2110,517,32,13,2,1919,23,16,8
2020-12-15T12:41:44.813576,52.530919999999995,13.3828566667, none, se,0.0017489961745625,22,36,45,7178,2075,371,30,13,2,1919,22,14,9
2020-12-15T12:41:45.834261,52.5309116667,13.38289, none, se,0.0017489961745625,24,39,47,7265,2109,519,32,13,2,1919,24,15,8
2020-12-15T12:41:46.853686,52.530903333299996,13.3829183333, none, se,0.0017489961745625,23,36,43,7032,2095,359,28,11,2,1919,23,13,7
2020-12-15T12:41:47.869861,52.5308916667,13.382945000000001, none, se,0.0017489961745625,23,35,41,6733,1905,349,26,9,2,1919,23,12,6
2020-12-15T12:41:48.888871,52.5308783333,13.382970000000002, none, e,0.0023204023368823,23,35,41,6733,1905,349,26,9,2,1919,23,12,6
2020-12-15T12:41:49.903128,52.53086,13.38299, none, e,0.0023204023368823,23,35,42,6915,1913,354,24,11,4,1919,23,12,7
2020-12-15T12:41:50.924238,52.5308433333,13.3830083333, none, e,0.0023204023368823,23,35,42,6915,1913,354,24,11,4,1919,23,12,7
2020-12-15T12:41:51.940331,52.53083,13.383028333299999, none, e,0.0023204023368823,21,33,38,6691,1885,344,17,6,2,1919,21,12,5
2020-12-15T12:41:52.956351,52.530809999999995,13.3830416667, none, e,0.0023204023368823,21,33,38,6691,1885,344,17,6,2,1919,21,12,5
2020-12-15T12:41:53.972509,52.5307916667,13.3830533333, none, e,0.0023204023368823,20,32,38,6452,1850,342,19,8,2,1919,20,12,6
2020-12-15T12:41:54.989510,52.5307783333,13.383065, none, e,0.0023204023368823,20,32,38,6452,1850,342,19,8,2,1919,20,12,6
2020-12-15T12:41:56.005772,52.5307616667,13.383068333299999, none, e,0.0023204023368823,21,32,38,6679,1889,332,17,8,2,1919,21,11,6
2020-12-15T12:41:57.023146,52.53074,13.383066666700001, none, ne,0.0023877921207132,21,32,38,6679,1889,332,17,8,2,1919,21,11,6
2020-12-15T12:41:58.038651,52.5307166667,13.383063333299999, none, ne,0.0023877921207132,23,36,41,7023,2084,355,19,8,2,1919,23,13,5
2020-12-15T12:41:59.054846,52.5306916667,13.3830566667, none, ne,0.0023877921207132,25,40,43,7743,2332,513,16,6,2,1919,25,15,3
2020-12-15T12:42:00.071852,52.530665,13.3830516667, none, ne,0.0023877921207132,27,42,46,8036,2387,518,20,6,2,1919,27,15,4
2020-12-15T12:42:01.088449,52.5306366667,13.3830483333, none, ne,0.0023877921207132,27,42,48,8218,2405,513,22,8,4,1919,27,15,6
2020-12-15T12:42:02.104888,52.5306266667,13.3830483333, none, ne,0.0023877921207132,26,43,50,8293,2424,533,22,8,4,1919,26,17,7
2020-12-15T12:42:03.122163,52.5306066667,13.3830533333, none, ne,0.0023877921207132,28,44,50,8571,2611,536,22,8,4,1919,28,16,6
2020-12-15T12:42:04.126201,52.5305916667,13.383054999999999, none, n,0.0023589627283788,29,46,50,8786,2645,546,20,6,2,1919,29,17,4
2020-12-15T12:42:05.145862,52.53058000000001,13.3830583333, none, n,0.0023589627283788,30,48,50,8995,2678,541,20,4,2,1919,30,18,2
2020-12-15T12:42:06.162374,52.5305816667,13.3830583333, none, n,0.0023589627283788,30,48,50,8965,2678,548,18,2,2,1919,30,18,2
2020-12-15T12:42:07.180400,52.53058000000001,13.383054999999999, none, n,0.0023589627283788,29,48,49,8738,2636,558,18,2,2,1919,29,19,1
2020-12-15T12:42:08.195504,52.5305783333,13.383054999999999, none, n,0.0023589627283788,29,49,51,8813,2661,568,20,2,2,1919,29,20,2
2020-12-15T12:42:09.211633,52.5305783333,13.383054999999999, none, n,0.0023589627283788,28,45,47,8275,2571,546,16,2,2,1919,28,17,2
2020-12-15T12:42:10.229694,52.5305783333,13.383054999999999, none, n,0.0023589627283788,27,45,46,8012,2406,556,14,2,2,1919,27,18,1
2020-12-15T12:42:11.245506,52.53058000000001,13.3830533333, none, n,0.0023589627283788,27,45,46,8012,2406,556,14,2,2,1919,27,18,1
2020-12-15T12:42:12.261571,52.530590000000004,13.38305, none, w,5.4248741694859006e-05,27,42,42,7982,2391,541,10,0,0,1919,27,15,0
2020-12-15T12:42:13.278131,52.5306033333,13.383045000000001, none, w,5.4248741694859006e-05,27,42,42,7982,2391,541,10,0,0,1919,27,15,0
2020-12-15T12:42:14.294109,52.530625,13.38304, none, w,5.4248741694859006e-05,26,42,42,7773,2369,528,12,0,0,1919,26,16,0
2020-12-15T12:42:15.310110,52.5306366667,13.3830383333, none, w,5.4248741694859006e-05,26,42,42,7773,2369,528,12,0,0,1919,26,16,0
2020-12-15T12:42:16.326362,52.5306466667,13.383035000000001, none, w,5.4248741694859006e-05,27,45,45,7997,2389,553,14,0,0,1919,27,18,0
2020-12-15T12:42:17.342913,52.53065,13.3830316667, none, w,5.4248741694859006e-05,27,44,44,7997,2389,553,14,0,0,1919,27,17,0
2020-12-15T12:42:18.359478,52.530625,13.383021666700001, none, w,5.4248741694859006e-05,26,42,42,7728,2340,535,14,0,0,1919,26,16,0
2020-12-15T12:42:19.376749,52.530590000000004,13.383016666700001, none, w,5.4248741694859006e-05,24,41,42,7480,2165,545,16,2,2,1919,24,17,1
2020-12-15T12:42:20.393380,52.5305583333,13.3830083333, none, nw,0.0006444535889332901,24,40,44,7495,2165,550,21,6,2,1919,24,16,4
2020-12-15T12:42:21.410075,52.5305283333,13.3830033333, none, nw,0.0006444535889332901,23,39,44,7256,2143,545,23,8,2,1919,23,16,5
2020-12-15T12:42:22.426900,52.5305,13.3830016667, none, nw,0.0006444535889332901,23,37,42,6939,2088,535,19,8,2,1919,23,14,5
2020-12-15T12:42:23.446163,52.5304716667,13.383, none, nw,0.0006444535889332901,22,37,43,6757,2073,547,21,10,2,1919,22,15,6
2020-12-15T12:42:24.461514,52.5304566667,13.3830016667, none, nw,0.0006444535889332901,21,35,44,6778,2070,537,21,12,2,1919,21,14,9
2020-12-15T12:42:25.477780,52.5304516667,13.3830016667, none, nw,0.0006444535889332901,21,38,45,6769,2070,557,28,12,2,1919,21,17,7
2020-12-15T12:42:26.492727,52.530475,13.3830016667, none, nw,0.0006444535889332901,22,38,45,7175,2100,545,26,12,2,1919,22,16,7
2020-12-15T12:42:27.513140,52.53054,13.383029999999998, none, nw,0.0006444535889332901,22,42,49,7169,2108,562,31,12,2,1919,22,20,7
2020-12-15T12:42:29.529174,52.530613333299996,13.3831016667, none, se,0.0012558027142462,23,44,51,7274,2150,575,33,12,2,1919,23,21,7
2020-12-15T12:42:30.549803,52.53063,13.383104999999999, none, se,0.0012558027142462,24,46,53,7477,2305,590,36,12,0,1919,24,22,7
2020-12-15T12:42:31.568701,52.5306483333,13.383076666700001, none, se,0.0012558027142462,24,46,50,7528,2322,583,31,8,0,1919,24,22,4
2020-12-15T12:42:32.585304,52.5306633333,13.3830466667, none, se,0.0012558027142462,24,46,50,7528,2322,583,31,8,0,1919,24,22,4
2020-12-15T12:42:33.610220,52.530675,13.383018333299999, none, se,0.0012558027142462,25,48,51,7985,2374,593,29,6,0,1919,25,23,3
2020-12-15T12:42:34.622181,52.53066999999999,13.382983333299999, none, se,0.0012558027142462,25,48,51,7985,2374,593,29,6,0,1919,25,23,3
2020-12-15T12:42:35.647700,52.5306883333,13.382945000000001, none, se,0.0012558027142462,25,48,53,8242,2401,588,31,8,2,1919,25,23,5
2020-12-15T12:42:36.670387,52.5306916667,13.38291, none, se,0.0012558027142462,25,48,53,8242,2401,588,31,8,2,1919,25,23,5
2020-12-15T12:42:37.691559,52.530705000000005,13.382878333299999, none, w,0.002603445099723,26,49,53,8484,2426,586,29,6,2,1919,26,23,4
2020-12-15T12:42:38.710319,52.5306916667,13.3828533333, none, w,0.002603445099723,26,49,53,8484,2426,586,29,6,2,1919,26,23,4
2020-12-15T12:42:39.732632,52.5306633333,13.382828333299999, none, w,0.002603445099723,26,49,51,8559,2564,586,27,4,2,1919,26,23,2
2020-12-15T12:42:40.740267,52.53061999999999,13.382791666700001, none, w,0.002603445099723,26,49,51,8741,2579,594,22,4,2,1919,26,23,2
2020-12-15T12:42:41.750117,52.5305866667,13.382743333299999, none, w,0.002603445099723,26,50,54,8559,2576,614,26,4,2,1919,26,24,4
2020-12-15T12:42:42.768922,52.5305333333,13.38269, none, w,0.002603445099723,26,46,48,8311,2406,572,19,4,2,1919,26,20,2
2020-12-15T12:42:43.793798,52.530535,13.382658333299998, none, w,0.002603445099723,26,46,49,8559,2428,574,19,4,2,1919,26,20,3
2020-12-15T12:42:44.810497,52.530530000000006,13.382625, none, w,0.002603445099723,26,44,45,8457,2393,547,12,2,2,1919,26,18,1
2020-12-15T12:42:45.827369,52.530525,13.3825933333, none, nw,0.0039699461200295,27,46,47,8795,2576,569,12,2,2,1919,27,19,1
2020-12-15T12:42:46.848526,52.5305083333,13.3825433333, none, nw,0.0039699461200295,27,46,49,8992,2596,569,14,4,4,1919,27,19,3
2020-12-15T12:42:47.868697,52.530515,13.382504999999998, none, nw,0.0039699461200295,28,48,49,8968,2604,576,16,2,2,1919,28,20,1
2020-12-15T12:42:48.882801,52.530519999999996,13.3824716667, none, nw,0.0039699461200295,28,47,48,8780,2596,558,18,2,2,1919,28,19,1
2020-12-15T12:42:49.906912,52.530523333299996,13.3824466667, none, nw,0.0039699461200295,28,49,52,8795,2618,573,22,4,2,1919,28,21,3
2020-12-15T12:42:50.931717,52.530590000000004,13.382418333299999, none, nw,0.0039699461200295,28,48,50,8726,2595,563,22,4,2,1919,28,20,2
2020-12-15T12:42:51.951631,52.530746666700004,13.382418333299999, none, nw,0.0039699461200295,27,47,50,8720,2590,563,18,4,2,1919,27,20,3
2020-12-15T12:42:52.967008,52.5308816667,13.3823966667, none, nw,0.0039699461200295,27,47,50,8720,2590,563,18,4,2,1919,27,20,3
2020-12-15T12:42:53.982327,52.53096,13.3823366667, none, sw,0.0073416157196751,28,47,50,8726,2587,573,18,4,2,1919,28,19,3
2020-12-15T12:42:54.997716,52.53103,13.382276666700001, none, sw,0.0073416157196751,28,47,50,8726,2587,573,18,4,2,1919,28,19,3
2020-12-15T12:42:56.012500,52.5310733333,13.38221, none, sw,0.0073416157196751,27,46,50,8553,2587,558,18,6,2,1919,27,19,4
2020-12-15T12:42:57.036935,52.5311116667,13.382155, none, sw,0.0073416157196751,27,46,50,8553,2587,558,18,6,2,1919,27,19,4
2020-12-15T12:42:58.057207,52.531144999999995,13.3821016667, none, sw,0.0073416157196751,27,46,50,8553,2582,555,20,6,2,1919,27,19,4
2020-12-15T12:42:59.070108,52.5311766667,13.3820566667, none, sw,0.0073416157196751,27,46,50,8553,2582,555,20,6,2,1919,27,19,4
2020-12-15T12:43:00.086471,52.5311966667,13.3820066667, none, sw,0.0073416157196751,27,44,48,8448,2422,545,18,6,2,1919,27,17,4
2020-12-15T12:43:01.104025,52.5312083333,13.381965, none, sw,0.0053348197136746,27,44,48,8448,2422,545,18,6,2,1919,27,17,4
2020-12-15T12:43:02.123475,52.531225,13.381915, none, sw,0.0053348197136746,26,42,46,8063,2387,540,16,4,0,1919,26,16,4
2020-12-15T12:43:03.143267,52.5312133333,13.381846666700001, none, sw,0.0053348197136746,26,42,46,8063,2387,540,16,4,0,1919,26,16,4
2020-12-15T12:43:04.159914,52.5312066667,13.38178, none, sw,0.0053348197136746,25,40,44,7982,2362,540,12,4,0,1919,25,15,4
2020-12-15T12:43:05.177494,52.5312133333,13.381715, none, sw,0.0053348197136746,25,40,43,7982,2362,540,12,4,0,1919,25,15,3
2020-12-15T12:43:06.193292,52.5311983333,13.381645, none, sw,0.0053348197136746,25,40,45,8057,2377,538,12,6,0,1919,25,15,5
2020-12-15T12:43:07.210457,52.5312133333,13.38159, none, sw,0.0053348197136746,25,40,45,8057,2377,538,12,6,0,1919,25,15,5
2020-12-15T12:43:08.225775,52.5312533333,13.3815483333, none, sw,0.0053348197136746,26,39,43,8209,2385,533,10,6,0,1919,26,13,4
2020-12-15T12:43:09.241559,52.531285,13.3815083333, none, w,0.0045778754610793,26,39,44,8209,2385,533,10,6,0,1919,26,13,5
2020-12-15T12:43:10.257943,52.531335,13.38146, none, w,0.0045778754610793,26,39,45,8299,2415,518,10,8,2,1919,26,13,6
2020-12-15T12:43:11.273905,52.5313666667,13.3814183333, none, w,0.0045778754610793,26,39,45,8299,2415,518,10,8,2,1919,26,13,6
2020-12-15T12:43:12.290785,52.531415,13.381385, none, w,0.0045778754610793,27,40,45,8562,2576,515,10,8,2,1919,27,13,5
2020-12-15T12:43:13.313538,52.5314516667,13.3813566667, none, w,0.0045778754610793,27,40,45,8562,2576,515,10,8,2,1919,27,13,5
2020-12-15T12:43:14.336952,52.5314783333,13.381314999999999, none, w,0.0045778754610793,27,40,46,8562,2574,517,10,8,2,1919,27,13,6
2020-12-15T12:43:15.349494,52.5315183333,13.381276666700002, none, w,0.0045778754610793,27,40,46,8562,2574,517,10,8,2,1919,27,13,6
2020-12-15T12:43:16.375921,52.5315333333,13.38124, none, w,0.0045778754610793,26,39,44,8517,2421,515,8,6,2,1919,26,13,5
2020-12-15T12:43:17.393067,52.531575,13.3812, none, sw,0.0054862350855817,26,39,44,8517,2421,515,8,6,2,1919,26,13,5
2020-12-15T12:43:18.409893,52.5316333333,13.381145000000002, none, sw,0.0054862350855817,27,39,45,8574,2567,525,10,8,2,1919,27,12,6
2020-12-15T12:43:19.427997,52.5316783333,13.3810816667, none, sw,0.0054862350855817,27,39,45,8574,2567,525,10,8,2,1919,27,12,6
2020-12-15T12:43:20.445091,52.5317033333,13.3810266667, none, sw,0.0054862350855817,26,39,45,8305,2389,533,10,8,2,1919,26,13,6
2020-12-15T12:43:21.459660,52.5317183333,13.3809716667, none, sw,0.0054862350855817,26,39,45,8305,2389,533,10,8,2,1919,26,13,6
2020-12-15T12:43:22.482031,52.5317333333,13.380920000000001, none, sw,0.0054862350855817,25,41,47,8260,2379,556,14,8,2,1919,25,16,6
2020-12-15T12:43:23.511261,52.5317516667,13.38086, none, sw,0.0054862350855817,25,41,47,8260,2379,556,14,8,2,1919,25,16,6
2020-12-15T12:43:25.510621,52.5318533333,13.38071, none, sw,0.0064782685757225,25,40,46,8057,2344,546,18,8,2,1919,25,15,6
2020-12-15T12:43:26.533834,52.531905,13.38067, none, sw,0.0064782685757225,25,40,46,8057,2344,546,18,8,2,1919,25,15,6
2020-12-15T12:43:27.550208,52.5319666667,13.380635, none, sw,0.0064782685757225,24,39,43,7764,2159,546,16,6,2,1919,24,15,4
2020-12-15T12:43:28.567605,52.53205500000001,13.3806166667, none, sw,0.0064782685757225,24,39,43,7764,2159,546,16,6,2,1919,24,15,4
2020-12-15T12:43:29.585954,52.5321333333,13.3805983333, none, sw,0.0064782685757225,23,38,41,7704,2149,541,14,4,2,1919,23,15,3
2020-12-15T12:43:30.601746,52.5321766667,13.3805566667, none, sw,0.0064782685757225,23,38,41,7704,2149,541,14,4,2,1919,23,15,3
2020-12-15T12:43:31.619167,52.5321933333,13.3805216667, none, sw,0.0064782685757225,24,39,40,7683,2147,556,12,2,0,1919,24,15,1
2020-12-15T12:43:32.636644,52.532201666700004,13.380486666700001, none, sw,0.0064782685757225,24,39,40,7683,2147,556,12,2,0,1919,24,15,1
2020-12-15T12:43:33.659033,52.5322266667,13.3804516667, none, sw,0.0064343673055835,22,38,39,7238,2095,551,12,2,0,1919,22,16,1
2020-12-15T12:43:34.675960,52.5322633333,13.3804233333, none, sw,0.0064343673055835,22,38,39,7238,2095,551,12,2,0,1919,22,16,1
2020-12-15T12:43:35.693272,52.532284999999995,13.380403333299999, none, sw,0.0064343673055835,22,36,39,7211,2085,544,14,4,0,1919,22,14,3
2020-12-15T12:43:36.710439,52.5322966667,13.380385, none, sw,0.0064343673055835,22,36,39,7211,2085,544,14,4,0,1919,22,14,3
2020-12-15T12:43:37.727937,52.532313333299996,13.380370000000001, none, sw,0.0064343673055835,22,36,39,6918,1908,541,14,4,0,1919,22,14,3
2020-12-15T12:43:38.744560,52.5323183333,13.3803616667, none, sw,0.0064343673055835,22,36,39,6918,1908,541,14,4,0,1919,22,14,3
2020-12-15T12:43:39.761880,52.5323283333,13.380348333299999, none, sw,0.0064343673055835,22,36,37,6775,1915,536,10,2,0,1919,22,14,1
2020-12-15T12:43:40.779261,52.53233,13.380348333299999, none, sw,0.0064343673055835,22,36,37,6775,1915,536,10,2,0,1919,22,14,1
2020-12-15T12:43:41.796122,52.5323416667,13.380339999999999, none, sw,0.0021216477587869,22,34,35,6664,1890,383,10,2,0,1919,22,12,1
2020-12-15T12:43:42.812103,52.532340000000005,13.380339999999999, none, sw,0.0021216477587869,22,34,35,6664,1890,383,10,2,0,1919,22,12,1
2020-12-15T12:43:43.828509,52.532356666700004,13.380329999999999, none, sw,0.0021216477587869,23,33,34,6912,1907,355,6,2,0,1919,23,10,1
2020-12-15T12:43:44.845020,52.5323633333,13.380320000000001, none, sw,0.0021216477587869,23,34,37,6978,2060,360,9,4,2,1919,23,11,3
2020-12-15T12:43:45.860950,52.532385,13.380303333299999, none, sw,0.0021216477587869,23,36,38,7187,2092,365,11,4,2,1919,23,13,2
2020-12-15T12:43:46.877374,52.532403333299996,13.380279999999999, none, sw,0.0021216477587869,23,36,38,7020,2074,363,11,4,2,1919,23,13,2
2020-12-15T12:43:47.893131,52.532425,13.380253333299999, none, sw,0.0021216477587869,22,36,41,6945,2051,360,20,8,4,1919,22,14,5
2020-12-15T12:43:48.909874,52.5324283333,13.380213333299999, none, sw,0.0021216477587869,20,37,43,6760,1903,368,22,8,4,1919,20,17,6
2020-12-15T12:43:49.926384,52.5324283333,13.3801716667, none, sw,0.0021309469210097,22,37,41,6930,1910,373,20,6,4,1919,22,15,4
2020-12-15T12:43:50.943065,52.5324366667,13.3801383333, none, sw,0.0021309469210097,23,39,44,7208,2083,376,22,6,4,1919,23,16,5
2020-12-15T12:43:51.945881,52.5324516667,13.380116666700001, none, sw,0.0021309469210097,23,39,44,7247,2090,522,22,6,4,1919,23,16,5
2020-12-15T12:43:52.966798,52.5324783333,13.3800916667, none, sw,0.0021309469210097,23,40,45,7501,2128,522,24,6,4,1919,23,17,5
2020-12-15T12:43:53.982889,52.5324733333,13.380071666700001, none, sw,0.0021309469210097,22,40,45,7238,2104,530,24,6,4,1919,22,18,5
2020-12-15T12:43:54.999822,52.5324683333,13.3800483333, none, sw,0.0021309469210097,23,39,42,7262,2114,525,17,4,2,1919,23,16,3
2020-12-15T12:43:56.015376,52.5325,13.38001, none, sw,0.0021309469210097,23,39,42,7211,2110,535,15,4,2,1919,23,16,3
2020-12-15T12:43:57.031809,52.5325716667,13.379978333299999, none, sw,0.0029452120997853,23,39,42,7211,2110,535,15,4,2,1919,23,16,3
2020-12-15T12:43:58.048165,52.5326216667,13.3799416667, none, sw,0.0029452120997853,23,39,48,7280,2123,550,24,11,6,1919,23,16,9
2020-12-15T12:43:59.063792,52.532665,13.3799183333, none, sw,0.0029452120997853,23,39,48,7280,2123,550,24,11,6,1919,23,16,9
2020-12-15T12:44:00.080537,52.5326883333,13.379886666700001, none, sw,0.0029452120997853,23,38,44,7235,2111,543,17,7,4,1919,23,15,6
2020-12-15T12:44:01.096728,52.532671666700004,13.379845000000001, none, sw,0.0029452120997853,23,38,44,7235,2111,543,17,7,4,1919,23,15,6
2020-12-15T12:44:02.112983,52.5326633333,13.3797966667, none, sw,0.0029452120997853,23,37,43,7023,2098,538,15,7,4,1919,23,14,6
2020-12-15T12:44:03.129572,52.5326916667,13.3797633333, none, sw,0.0029452120997853,23,37,43,7023,2098,538,15,7,4,1919,23,14,6
2020-12-15T12:44:04.145598,52.532715,13.3797283333, none, sw,0.0029452120997853,22,37,42,7023,2106,538,15,7,4,1919,22,15,5
2020-12-15T12:44:05.163058,52.5327216667,13.379696666700001, none, sw,0.0036173681709528,22,37,42,7023,2106,538,15,7,4,1919,22,15,5
2020-12-15T12:44:06.179051,52.5327766667,13.3796733333, none, sw,0.0036173681709528,22,37,42,6984,2098,530,13,7,4,1919,22,15,5
2020-12-15T12:44:07.195794,52.5328516667,13.37965, none, sw,0.0036173681709528,22,37,42,6984,2098,530,13,7,4,1919,22,15,5
2020-12-15T12:44:08.211844,52.5328966667,13.379615, none, sw,0.0036173681709528,23,36,42,6939,2084,517,13,7,4,1919,23,13,6
2020-12-15T12:44:09.228034,52.5329283333,13.3795766667, none, sw,0.0036173681709528,23,36,42,6939,2084,517,13,7,4,1919,23,13,6
2020-12-15T12:44:10.244781,52.5329416667,13.379548333299999, none, sw,0.0036173681709528,23,36,42,6772,2076,514,11,7,4,1919,23,13,6
2020-12-15T12:44:11.260687,52.533006666700004,13.379529999999999, none, sw,0.0036173681709528,23,36,42,6772,2076,514,11,7,4,1919,23,13,6
2020-12-15T12:44:12.277448,52.5330766667,13.3795183333, none, sw,0.0036173681709528,23,36,42,6766,2073,519,11,7,4,1919,23,13,6
2020-12-15T12:44:13.293824,52.5331116667,13.379495, none, sw,0.006494403694659,23,36,42,6766,2073,519,11,7,4,1919,23,13,6
2020-12-15T12:44:14.309968,52.5331483333,13.379470000000001, none, sw,0.006494403694659,22,36,43,6661,1908,514,20,9,6,1919,22,14,7
2020-12-15T12:44:15.326919,52.5331766667,13.379454999999998, none, sw,0.006494403694659,22,36,43,6661,1908,514,20,9,6,1919,22,14,7
2020-12-15T12:44:16.343513,52.5332116667,13.3794316667, none, sw,0.006494403694659,22,36,44,6676,1898,383,24,11,6,1919,22,14,8
2020-12-15T12:44:17.360653,52.5332366667,13.379404999999998, none, sw,0.006494403694659,22,36,44,6676,1898,383,24,11,6,1919,22,14,8
2020-12-15T12:44:18.377625,52.533275,13.3793766667, none, sw,0.006494403694659,21,34,37,6270,1858,355,15,4,2,1919,21,13,3
2020-12-15T12:44:19.394981,52.533319999999996,13.37936, none, sw,0.006494403694659,21,34,37,6270,1858,355,15,4,2,1919,21,13,3
2020-12-15T12:44:20.411939,52.5333733333,13.379351666700002, none, sw,0.006494403694659,22,34,36,6449,1870,347,13,4,2,1919,22,12,2
2020-12-15T12:44:21.429638,52.5334283333,13.379335000000001, none, sw,0.0052624774736616,22,34,36,6449,1870,347,13,4,2,1919,22,12,2
2020-12-15T12:44:22.446896,52.5334833333,13.3793016667, none, sw,0.0052624774736616,23,35,43,6960,2073,342,20,11,6,1919,23,12,8
2020-12-15T12:44:23.464000,52.53355,13.379275, none, sw,0.0052624774736616,23,35,43,6960,2073,342,20,11,6,1919,23,12,8
2020-12-15T12:44:24.481886,52.5335766667,13.379245000000001, none, sw,0.0052624774736616,24,35,43,6975,2085,329,20,11,6,1919,24,11,8
2020-12-15T12:44:25.499947,52.5335966667,13.379226666700001, none, sw,0.0052624774736616,24,35,43,6975,2085,329,20,11,6,1919,24,11,8
2020-12-15T12:44:26.516542,52.5336333333,13.3791966667, none, sw,0.0052624774736616,24,36,45,6990,2090,357,22,11,6,1919,24,12,9
2020-12-15T12:44:28.533833,52.5337366667,13.3790683333, none, sw,0.0052624774736616,24,36,45,6990,2090,357,22,11,6,1919,24,12,9
2020-12-15T12:44:29.551343,52.533723333299996,13.379014999999999, none, sw,0.0056142861220667,23,35,44,6954,2067,345,22,11,6,1919,23,12,9
2020-12-15T12:44:30.568335,52.5337416667,13.3789716667, none, sw,0.0056142861220667,22,37,45,6999,2075,365,24,11,6,1919,22,15,8
2020-12-15T12:44:31.585610,52.53378000000001,13.378948333299999, none, sw,0.0056142861220667,23,38,46,7193,2095,360,28,11,6,1919,23,15,8
2020-12-15T12:44:32.602680,52.5338483333,13.378929999999999, none, sw,0.0056142861220667,23,38,43,7447,2139,353,21,9,4,1919,23,15,5
2020-12-15T12:44:33.619915,52.5338733333,13.3789083333, none, sw,0.0056142861220667,23,37,42,7432,2139,343,19,9,4,1919,23,14,5
2020-12-15T12:44:34.636779,52.533915,13.37889, none, sw,0.0056142861220667,25,38,45,7680,2309,361,21,11,4,1919,25,13,7
2020-12-15T12:44:35.654122,52.53395,13.3788566667, none, sw,0.0056142861220667,25,40,46,7770,2342,371,21,11,4,1919,25,15,6
2020-12-15T12:44:36.671457,52.5339983333,13.378836666700002, none, sw,0.0056142861220667,24,40,44,7498,2162,376,16,6,2,1919,24,16,4
2020-12-15T12:44:37.688983,52.5340283333,13.378806666700001, none, sw,0.0052464802024258,23,40,44,7447,2145,519,18,6,2,1919,23,17,4
2020-12-15T12:44:38.708390,52.534083333299996,13.378795000000002, none, sw,0.0052464802024258,23,40,46,7432,2138,383,23,8,2,1919,23,17,6
2020-12-15T12:44:39.723866,52.5340966667,13.378775, none, sw,0.0052464802024258,23,42,46,7453,2156,526,25,8,2,1919,23,19,4
2020-12-15T12:44:40.741468,52.5341083333,13.37875, none, sw,0.0052464802024258,23,39,45,7295,2146,519,25,8,2,1919,23,16,6
2020-12-15T12:44:41.758280,52.5341333333,13.378735, none, sw,0.0052464802024258,24,39,45,7498,2166,524,21,8,2,1919,24,15,6
2020-12-15T12:44:42.775749,52.534144999999995,13.378720000000001, none, sw,0.0052464802024258,24,39,45,7498,2166,524,21,8,2,1919,24,15,6
2020-12-15T12:44:43.792479,52.5341383333,13.3786983333, none, sw,0.0052464802024258,24,40,48,7543,2171,541,23,12,2,1919,24,16,8
2020-12-15T12:44:44.809493,52.5340866667,13.3786216667, none, sw,0.0052464802024258,24,40,48,7543,2171,541,23,12,2,1919,24,16,8
2020-12-15T12:44:45.826501,52.5340933333,13.378565, none, w,0.0025532232376801,26,44,50,7979,2353,564,25,10,2,1919,26,18,6
2020-12-15T12:44:46.843301,52.534128333299996,13.378525, none, w,0.0025532232376801,26,44,50,7979,2353,564,25,10,2,1919,26,18,6
2020-12-15T12:44:47.862452,52.5341733333,13.378515, none, w,0.0025532232376801,25,43,48,7770,2324,556,23,8,2,1919,25,18,5
2020-12-15T12:44:48.884914,52.5342216667,13.3784933333, none, w,0.0025532232376801,24,42,47,7704,2168,559,23,8,2,1919,24,18,5
2020-12-15T12:44:49.902145,52.5342716667,13.378466666700001, none, w,0.0025532232376801,26,44,49,8209,2385,569,25,8,2,1919,26,18,5
2020-12-15T12:44:50.918214,52.534330000000004,13.3784366667, none, w,0.0025532232376801,27,45,50,8284,2404,569,27,8,2,1919,27,18,5
2020-12-15T12:44:51.934927,52.534375,13.3784033333, none, w,0.0025532232376801,27,44,47,8233,2396,549,20,6,2,1919,27,17,3
2020-12-15T12:44:52.956609,52.5344216667,13.3783683333, none, w,0.0025532232376801,27,44,49,8278,2423,556,20,8,2,1919,27,17,5
2020-12-15T12:44:53.960955,52.5344666667,13.378326666700001, none, sw,0.0063618360041453,28,46,53,8535,2605,576,22,10,2,1919,28,18,7
2020-12-15T12:44:54.968819,52.5345116667,13.378285, none, sw,0.0063618360041453,28,46,53,8535,2602,573,22,10,2,1919,28,18,7
2020-12-15T12:44:55.992084,52.5345633333,13.378243333299999, none, sw,0.0063618360041453,27,45,48,8311,2580,556,18,6,2,1919,27,18,3
2020-12-15T12:44:57.004200,52.5346233333,13.3782016667, none, sw,0.0063618360041453,26,45,48,8251,2565,556,21,6,2,1919,26,19,3
2020-12-15T12:44:58.023414,52.53468,13.3781616667, none, sw,0.0063618360041453,26,45,50,8257,2567,561,23,8,4,1919,26,19,5
2020-12-15T12:44:59.039502,52.5347266667,13.378131666700002, none, sw,0.0063618360041453,26,43,49,8218,2420,553,23,8,4,1919,26,17,6
2020-12-15T12:45:00.058716,52.534769999999995,13.378098333299999, none, sw,0.0063618360041453,24,42,45,7707,2336,533,19,6,2,1919,24,18,3
2020-12-15T12:45:01.073541,52.534819999999996,13.3780716667, none, sw,0.0061297177362648,24,42,45,7707,2336,533,19,6,2,1919,24,18,3
2020-12-15T12:45:02.089454,52.53485,13.378045000000002, none, sw,0.0061297177362648,24,40,44,7534,2322,521,15,6,2,1919,24,16,4
2020-12-15T12:45:03.105500,52.5348766667,13.378025, none, sw,0.0061297177362648,24,39,44,7534,2322,521,15,6,2,1919,24,15,5
2020-12-15T12:45:04.121564,52.5349033333,13.377998333299999, none, sw,0.0061297177362648,25,40,45,7946,2367,524,15,6,2,1919,25,15,5
2020-12-15T12:45:05.143421,52.534955000000004,13.377968333299998, none, sw,0.0061297177362648,25,40,45,7946,2367,524,15,6,2,1919,25,15,5
2020-12-15T12:45:06.159345,52.5350033333,13.3779266667, none, sw,0.0061297177362648,26,41,43,8200,2389,522,13,4,2,1919,26,15,2
2020-12-15T12:45:07.175636,52.53505,13.3778916667, none, sw,0.0061297177362648,26,39,42,8003,2359,514,13,4,2,1919,26,13,3
2020-12-15T12:45:08.191855,52.5350866667,13.377854999999998, none, sw,0.0061297177362648,25,39,41,7785,2332,512,13,4,2,1919,25,14,2
2020-12-15T12:45:09.209401,52.535115000000005,13.37783, none, sw,0.0052356359688812,24,39,43,7680,2172,532,15,6,2,1919,24,15,4
2020-12-15T12:45:10.224231,52.535135,13.37781, none, sw,0.0052356359688812,24,39,42,7468,2155,522,12,6,2,1919,24,15,3
2020-12-15T12:45:11.240542,52.5351516667,13.3777833333, none, sw,0.0052356359688812,25,39,42,7504,2170,520,14,6,0,1919,25,14,3
2020-12-15T12:45:12.257573,52.535180000000004,13.3777416667, none, sw,0.0052356359688812,24,40,43,7468,2175,518,14,6,0,1919,24,16,3
2020-12-15T12:45:13.273175,52.535205000000005,13.377695000000001, none, sw,0.0052356359688812,25,42,45,7549,2322,530,18,6,0,1919,25,17,3
2020-12-15T12:45:14.288872,52.5352183333,13.3776566667, none, sw,0.0052356359688812,24,42,45,7513,2317,550,18,6,0,1919,24,18,3
2020-12-15T12:45:15.305507,52.535223333299996,13.3776183333, none, sw,0.0052356359688812,23,42,47,7178,2122,557,25,8,2,1919,23,19,5
2020-12-15T12:45:16.321638,52.53524,13.377573333299999, none, sw,0.0052356359688812,22,43,48,6969,2102,567,29,10,2,1919,22,21,5
2020-12-15T12:45:17.340313,52.535275,13.377538333299999, none, sw,0.0037949893270607,22,40,46,6745,2068,552,25,8,2,1919,22,18,6
2020-12-15T12:45:18.356567,52.5353016667,13.3775033333, none, sw,0.0037949893270607,21,42,49,6715,2063,554,32,12,2,1919,21,21,7
2020-12-15T12:45:19.375653,52.5353316667,13.3774616667, none, sw,0.0037949893270607,21,42,49,6715,2063,554,32,12,2,1919,21,21,7
2020-12-15T12:45:20.393774,52.5353783333,13.3774233333, none, sw,0.0037949893270607,20,41,48,6781,2078,544,32,10,2,1919,20,21,7
2020-12-15T12:45:21.410303,52.535403333299996,13.377381666700002, none, sw,0.0037949893270607,20,41,48,6781,2078,544,32,10,2,1919,20,21,7
2020-12-15T12:45:22.414475,52.5353983333,13.377336666700002, none, sw,0.0037949893270607,20,40,48,6751,2058,531,30,12,2,1919,20,20,8
2020-12-15T12:45:23.436496,52.535405000000004,13.377293333299999, none, sw,0.0037949893270607,21,41,48,6751,2058,531,30,12,2,1919,21,20,7
2020-12-15T12:45:24.453341,52.535455000000006,13.377254999999998, none, sw,0.0037949893270607,21,41,47,6745,2051,536,30,10,2,1919,21,20,6
2020-12-15T12:45:25.471075,52.5355033333,13.3772233333, none, sw,0.0047349316728935,21,41,47,6745,2051,536,30,10,2,1919,21,20,6
2020-12-15T12:45:26.488199,52.53552,13.377201666700001, none, sw,0.0047349316728935,22,42,49,6954,2075,538,34,12,2,1919,22,20,7
2020-12-15T12:45:27.505883,52.5355216667,13.377170000000001, none, sw,0.0047349316728935,22,42,49,6954,2075,538,34,12,2,1919,22,20,7
2020-12-15T12:45:28.522633,52.5355516667,13.3771316667, none, sw,0.0047349316728935,22,40,48,6924,2070,536,34,12,2,1919,22,18,8
2020-12-15T12:45:30.539675,52.5356133333,13.376985000000001, none, sw,0.0047349316728935,22,40,48,6924,2070,536,34,12,2,1919,22,18,8
2020-12-15T12:45:31.556487,52.535605000000004,13.376929999999998, none, sw,0.0047349316728935,22,40,48,6951,2067,526,34,12,2,1919,22,18,8
2020-12-15T12:45:32.575355,52.535619999999994,13.376873333299999, none, sw,0.0047349316728935,22,40,48,6951,2067,526,34,12,2,1919,22,18,8
2020-12-15T12:45:33.592043,52.535648333299996,13.376829999999998, none, w,0.0044440117562808,23,40,48,7169,2102,546,29,12,0,1919,23,17,8
2020-12-15T12:45:34.609698,52.535655000000006,13.376788333299999, none, w,0.0044440117562808,23,41,48,7169,2102,546,29,12,0,1919,23,18,7
2020-12-15T12:45:35.624384,52.535685,13.3767516667, none, w,0.0044440117562808,23,38,47,6951,2078,531,32,14,0,1919,23,15,9
2020-12-15T12:45:36.638892,52.5356866667,13.3767116667, none, w,0.0044440117562808,23,38,47,6951,2078,531,32,14,0,1919,23,15,9
2020-12-15T12:45:37.654082,52.53570500000001,13.376675, none, w,0.0044440117562808,23,39,48,7032,2112,529,32,14,0,1919,23,16,9
2020-12-15T12:45:38.675595,52.5357416667,13.376636666700001, none, w,0.0044440117562808,23,39,48,7032,2112,529,32,14,0,1919,23,16,9
2020-12-15T12:45:39.691907,52.535785,13.376605, none, w,0.0044440117562808,24,40,47,7462,2159,537,27,12,0,1919,24,16,7
2020-12-15T12:45:40.708475,52.535825,13.3765683333, none, w,0.0044440117562808,24,39,47,7292,2144,537,27,12,0,1919,24,15,8
2020-12-15T12:45:41.725998,52.535869999999996,13.376529999999999, none, sw,0.0045608078955873,24,40,45,7241,2124,532,27,10,0,1919,24,16,5
2020-12-15T12:45:42.741732,52.5358766667,13.376489999999999, none, sw,0.0045608078955873,24,40,45,7256,2133,532,25,10,0,1919,24,16,5
2020-12-15T12:45:43.765764,52.5358816667,13.376453333299999, none, sw,0.0045608078955873,24,40,45,7265,2136,537,25,8,0,1919,24,16,5
2020-12-15T12:45:44.781326,52.5359033333,13.37641, none, sw,0.0045608078955873,23,38,44,7178,2109,532,23,8,0,1919,23,15,6
2020-12-15T12:45:45.801615,52.535940000000004,13.3763866667, none, sw,0.0045608078955873,24,40,47,7232,2136,554,30,12,0,1919,24,16,7
2020-12-15T12:45:46.825184,52.535959999999996,13.376370000000001, none, sw,0.0045608078955873,24,40,47,7268,2148,539,28,10,0,1919,24,16,7
2020-12-15T12:45:47.841228,52.5359916667,13.376368333299999, none, sw,0.0045608078955873,25,42,45,7537,2320,536,21,6,0,1919,25,17,3
2020-12-15T12:45:48.862149,52.5360183333,13.3763766667, none, sw,0.0045608078955873,25,42,46,7537,2313,531,23,6,0,1919,25,17,4
2020-12-15T12:45:49.882581,52.5360566667,13.3763883333, none, sw,0.0032659251878106,24,42,44,7295,2153,528,21,4,0,1919,24,18,2
2020-12-15T12:45:50.901751,52.5360833333,13.3763883333, none, sw,0.0032659251878106,24,42,44,7241,2143,382,23,4,0,1919,24,18,2
2020-12-15T12:45:51.917184,52.5361083333,13.3763766667, none, sw,0.0032659251878106,24,40,43,7280,2156,377,21,4,0,1919,24,16,3
2020-12-15T12:45:52.932415,52.5361316667,13.376363333299999, none, sw,0.0032659251878106,24,40,43,7280,2156,377,21,4,0,1919,24,16,3
2020-12-15T12:45:53.955207,52.536145,13.3763433333, none, sw,0.0032659251878106,23,39,42,7199,2122,367,21,4,0,1919,23,16,3
2020-12-15T12:45:54.973052,52.5361566667,13.376325, none, sw,0.0032659251878106,23,39,42,7199,2122,367,21,4,0,1919,23,16,3
2020-12-15T12:45:55.990228,52.5361833333,13.3762966667, none, sw,0.0032659251878106,23,38,40,7032,2107,355,17,4,0,1919,23,15,2
2020-12-15T12:45:57.014482,52.5362166667,13.376270000000002, none, sw,0.0032659251878106,23,38,40,7032,2107,355,17,4,0,1919,23,15,2
2020-12-15T12:45:58.032151,52.5362483333,13.37624, none, sw,0.0033650895017848,23,37,39,7038,2112,347,15,4,0,1919,23,14,2
2020-12-15T12:45:59.048259,52.5362816667,13.3762016667, none, sw,0.0033650895017848,23,37,39,7038,2112,347,15,4,0,1919,23,14,2
2020-12-15T12:46:00.067779,52.536319999999996,13.37616, none, sw,0.0033650895017848,22,34,34,6918,2063,310,8,0,0,1919,22,12,0
2020-12-15T12:46:01.084558,52.5363566667,13.376120000000002, none, sw,0.0033650895017848,22,34,34,6918,2063,310,8,0,0,1919,22,12,0
2020-12-15T12:46:02.101864,52.536375,13.376075, none, sw,0.0033650895017848,22,34,34,6709,1905,303,8,0,0,1919,22,12,0
2020-12-15T12:46:03.123317,52.5364033333,13.376031666700001, none, sw,0.0033650895017848,22,34,34,6709,1905,303,8,0,0,1919,22,12,0
2020-12-15T12:46:04.141424,52.536415000000005,13.375991666700001, none, sw,0.0033650895017848,21,32,32,6267,1843,293,8,0,0,1919,21,11,0
2020-12-15T12:46:05.159652,52.5364266667,13.3759616667, none, sw,0.0033650895017848,21,32,32,6267,1843,293,8,0,0,1919,21,11,0
2020-12-15T12:46:06.177678,52.53645,13.37594, none, sw,0.0043202319847721,21,30,30,6246,1843,303,6,0,0,1919,21,9,0
2020-12-15T12:46:07.203782,52.536485,13.3759066667, none, sw,0.0043202319847721,21,30,30,6246,1843,303,6,0,0,1919,21,9,0
2020-12-15T12:46:08.220551,52.5365183333,13.37587, none, sw,0.0043202319847721,20,28,28,6159,1823,276,6,0,0,1919,20,8,0
2020-12-15T12:46:09.236817,52.5365633333,13.375843333299999, none, sw,0.0043202319847721,20,28,28,6159,1823,276,6,0,0,1919,20,8,0
2020-12-15T12:46:10.255606,52.536590000000004,13.3758266667, none, sw,0.0043202319847721,19,28,29,6153,1815,289,4,2,0,1919,19,9,1
2020-12-15T12:46:11.275927,52.5366383333,13.375805, none, sw,0.0043202319847721,19,28,29,6153,1815,289,4,2,0,1919,19,9,1
2020-12-15T12:46:12.289993,52.5366866667,13.375775, none, sw,0.0043202319847721,20,27,30,5926,1792,297,4,2,0,1919,20,7,3
2020-12-15T12:46:13.309144,52.5367466667,13.375751666700001, none, sw,0.0043202319847721,20,27,30,5926,1792,297,4,2,0,1919,20,7,3
2020-12-15T12:46:14.327549,52.53683,13.375735, none, sw,0.0063529538452069,20,29,30,5941,1799,294,6,2,0,1919,20,9,1
2020-12-15T12:46:15.339415,52.5368783333,13.375708333299999, none, sw,0.0063529538452069,19,29,31,5950,1663,319,8,2,0,1919,19,10,2
2020-12-15T12:46:16.346195,52.5369266667,13.37568, none, sw,0.0063529538452069,19,32,33,5995,1794,332,15,2,0,1919,19,13,1
2020-12-15T12:46:17.368296,52.5369783333,13.375651666700001, none, sw,0.0063529538452069,18,34,35,5950,1658,352,17,2,0,1919,18,16,1
2020-12-15T12:46:18.389302,52.5370283333,13.3756216667, none, sw,0.0063529538452069,18,35,37,5995,1801,359,21,4,2,1919,18,17,2
2020-12-15T12:46:19.412357,52.537081666700004,13.3755883333, none, sw,0.0063529538452069,18,37,40,6234,1838,517,23,4,2,1919,18,19,3
2020-12-15T12:46:20.432594,52.5371066667,13.3755416667, none, sw,0.0063529538452069,17,37,39,5986,1663,514,25,4,2,1919,17,20,2
2020-12-15T12:46:21.455233,52.5371366667,13.3754983333, none, sw,0.0063529538452069,16,37,41,5947,1648,531,27,6,2,1919,16,21,4
2020-12-15T12:46:22.459289,52.5371783333,13.375466666700001, none, sw,0.0061105434438954,17,40,43,5998,1801,541,32,4,2,1919,17,23,3
2020-12-15T12:46:23.483177,52.5372016667,13.3754316667, none, sw,0.0061105434438954,17,41,44,6186,1811,546,34,4,2,1919,17,24,3
2020-12-15T12:46:24.501876,52.5372016667,13.3753866667, none, sw,0.0061105434438954,17,41,43,6192,1819,556,30,4,2,1919,17,24,2
2020-12-15T12:46:25.515986,52.5371883333,13.375335, none, sw,0.0061105434438954,17,39,43,6147,1819,541,30,4,2,1919,17,22,4
2020-12-15T12:46:27.530501,52.537105000000004,13.375138333299999, none, sw,0.0061105434438954,16,39,42,5953,1806,548,27,4,2,1919,16,23,3
2020-12-15T12:46:28.541517,52.5371283333,13.375105, none, sw,0.0061105434438954,16,39,42,5953,1806,548,27,4,2,1919,16,23,3
2020-12-15T12:46:29.564226,52.5371583333,13.375070000000001, none, sw,0.0061105434438954,18,37,41,5962,1816,535,25,4,2,1919,18,19,4
2020-12-15T12:46:30.591333,52.537191666700004,13.3750383333, none, w,0.0041439745252052,18,37,38,5917,1806,530,21,2,0,1919,18,19,1
2020-12-15T12:46:31.609905,52.5372316667,13.375015, none, w,0.0041439745252052,17,35,39,5723,1654,518,26,6,0,1919,17,18,4
2020-12-15T12:46:32.634319,52.5372466667,13.374996666700001, none, w,0.0041439745252052,18,36,39,5905,1814,518,24,6,0,1919,18,18,3
2020-12-15T12:46:33.651456,52.537255,13.3749833333, none, w,0.0041439745252052,18,36,39,5717,1794,521,29,4,0,1919,18,18,3
2020-12-15T12:46:34.668136,52.537240000000004,13.3749783333, none, w,0.0041439745252052,18,35,37,5702,1661,518,22,4,0,1919,18,17,2
2020-12-15T12:46:35.685239,52.5372466667,13.37496, none, w,0.0041439745252052,19,35,37,5890,1817,523,20,4,0,1919,19,16,2
2020-12-15T12:46:36.703031,52.537234999999995,13.374953333299999, none, w,0.0041439745252052,19,36,38,5890,1817,523,22,4,0,1919,19,17,2
2020-12-15T12:46:37.719212,52.53723000000001,13.374941666700002, none, w,0.0041439745252052,18,34,37,5672,1650,520,20,4,0,1919,18,16,3
2020-12-15T12:46:38.735821,52.537236666700004,13.374920000000001, none, w,0.0013483977359162,18,33,35,5642,1645,375,16,4,0,1919,18,15,2
2020-12-15T12:46:39.752725,52.5372516667,13.374896666700002, none, w,0.0013483977359162,18,34,37,5687,1653,513,20,6,0,1919,18,16,3
2020-12-15T12:46:40.769558,52.5372633333,13.37488, none, w,0.0013483977359162,18,36,39,5947,1818,528,24,6,0,1919,18,18,3
2020-12-15T12:46:41.786255,52.53728,13.374856666700001, none, w,0.0013483977359162,18,37,40,5983,1832,530,29,6,0,1919,18,19,3
2020-12-15T12:46:42.803413,52.5373066667,13.3748266667, none, w,0.0013483977359162,18,37,41,5983,1832,530,29,6,0,1919,18,19,4
2020-12-15T12:46:43.819287,52.537330000000004,13.3748, none, w,0.0013483977359162,18,36,41,5953,1820,520,29,6,0,1919,18,18,5
2020-12-15T12:46:44.839608,52.5373533333,13.374775, none, w,0.0013483977359162,19,36,42,6171,1853,382,24,8,2,1919,19,17,6
2020-12-15T12:46:45.839845,52.537375,13.3747516667, none, w,0.0013483977359162,19,37,43,6237,1870,382,26,8,2,1919,19,18,6
2020-12-15T12:46:46.863435,52.5373933333,13.3747316667, none, sw,0.0030829445832766,18,36,42,5983,1835,367,26,8,2,1919,18,18,6
2020-12-15T12:46:47.883950,52.5374233333,13.37471, none, sw,0.0030829445832766,18,35,42,5983,1835,370,28,10,2,1919,18,17,7
2020-12-15T12:46:48.898611,52.537445,13.3746916667, none, sw,0.0030829445832766,19,35,42,5992,1835,358,30,10,2,1919,19,16,7
2020-12-15T12:46:49.914206,52.537475,13.374668333299999, none, sw,0.0030829445832766,19,36,44,6165,1850,365,34,12,2,1919,19,17,8
2020-12-15T12:46:50.932793,52.537506666700004,13.37464, none, sw,0.0030829445832766,19,34,41,5977,1825,348,32,10,2,1919,19,15,7
2020-12-15T12:46:51.949792,52.5375333333,13.374618333299999, none, sw,0.0030829445832766,18,31,37,5663,1628,333,28,10,2,1919,18,13,6
2020-12-15T12:46:52.964424,52.537555000000005,13.3746, none, sw,0.0030829445832766,18,29,33,5439,1601,326,18,6,2,1919,18,11,4
2020-12-15T12:46:53.980865,52.537580000000005,13.3745916667, none, sw,0.0030829445832766,17,29,34,5445,1603,331,20,6,2,1919,17,12,5
2020-12-15T12:46:54.997764,52.5376166667,13.374581666700001, none, sw,0.0038322714171736,16,31,33,5212,1570,348,22,4,0,1919,16,15,2
2020-12-15T12:46:56.013813,52.5376433333,13.374571666700001, none, sw,0.0038322714171736,16,28,30,5125,1405,333,20,4,0,1919,16,12,2
2020-12-15T12:46:57.030721,52.537663333299996,13.37456, none, sw,0.0038322714171736,16,28,30,5125,1405,333,20,4,0,1919,16,12,2
2020-12-15T12:46:58.046533,52.5376566667,13.374545000000001, none, sw,0.0038322714171736,16,28,31,5215,1560,335,22,4,0,1919,16,12,3
2020-12-15T12:46:59.052569,52.53765,13.374526666700001, none, sw,0.0038322714171736,16,28,31,5215,1560,335,22,4,0,1919,16,12,3
2020-12-15T12:47:00.081146,52.53763000000001,13.37451, none, sw,0.0038322714171736,16,27,30,4982,1399,320,20,2,0,1919,16,11,3
2020-12-15T12:47:01.103423,52.5376066667,13.3744983333, none, sw,0.0038322714171736,16,27,30,4982,1399,320,20,2,0,1919,16,11,3
2020-12-15T12:47:02.119960,52.5376033333,13.374493333299998, none, w,0.00087934850887248,16,27,30,4988,1406,320,18,2,0,1919,16,11,3
2020-12-15T12:47:03.135043,52.537618333299996,13.3745, none, w,0.00087934850887248,16,27,29,4988,1406,320,18,2,0,1919,16,11,2
2020-12-15T12:47:04.152232,52.5376683333,13.3745066667, none, w,0.00087934850887248,16,27,27,5152,1537,325,14,0,0,1919,16,11,0
2020-12-15T12:47:05.168954,52.5377133333,13.3744966667, none, w,0.00087934850887248,16,27,27,5152,1537,325,14,0,0,1919,16,11,0
2020-12-15T12:47:06.184932,52.5377566667,13.374481666700001, none, w,0.00087934850887248,16,29,31,5242,1572,347,14,2,2,1919,16,13,2
2020-12-15T12:47:07.201140,52.537819999999996,13.3744583333, none, w,0.00087934850887248,16,29,30,5242,1572,347,14,2,2,1919,16,13,1
2020-12-15T12:47:08.217389,52.5378683333,13.374445000000001, none, w,0.00087934850887248,18,30,33,5496,1624,345,14,2,2,1919,18,12,3
2020-12-15T12:47:09.239435,52.5379216667,13.374431666700001, none, w,0.00087934850887248,18,30,33,5496,1624,345,14,2,2,1919,18,12,3
2020-12-15T12:47:10.241755,52.5379666667,13.3744066667, none, s,0.0058319762771558,17,29,34,5475,1604,332,16,6,4,1919,17,12,5
2020-12-15T12:47:11.250503,52.5380116667,13.374383333299999, none, s,0.0058319762771558,17,29,35,5475,1599,332,16,8,4,1919,17,12,6
2020-12-15T12:47:12.271294,52.5380633333,13.374353333299998, none, s,0.0058319762771558,17,26,33,5439,1584,307,12,8,4,1919,17,9,7
2020-12-15T12:47:13.289616,52.538109999999996,13.374329999999999, none, s,0.0058319762771558,18,28,34,5469,1609,325,14,8,4,1919,18,10,6
2020-12-15T12:47:14.306432,52.538155,13.374301666700001, none, s,0.0058319762771558,18,29,36,5648,1621,340,16,10,4,1919,18,11,7
2020-12-15T12:47:15.324966,52.53819,13.374285, none, s,0.0058319762771558,19,33,39,6150,1819,360,18,10,4,1919,19,14,6
2020-12-15T12:47:16.336910,52.5382183333,13.374279999999999, none, s,0.0058319762771558,21,35,43,6488,1891,515,18,10,4,1919,21,14,8
2020-12-15T12:47:17.350343,52.53825500000001,13.374256666700001, none, s,0.0058319762771558,22,36,44,6712,2058,518,20,10,4,1919,22,14,8
2020-12-15T12:47:18.370579,52.538295,13.3742316667, none, sw,0.0054828143419306,23,36,42,6987,2097,375,18,8,2,1919,23,13,6
2020-12-15T12:47:19.394396,52.5383366667,13.374201666700001, none, sw,0.0054828143419306,24,38,46,7250,2134,528,22,12,2,1919,24,14,8
2020-12-15T12:47:20.410725,52.5383766667,13.3741866667, none, sw,0.0054828143419306,25,43,48,7707,2342,551,22,10,0,1919,25,18,5
2020-12-15T12:47:21.427753,52.5384183333,13.3741816667, none, sw,0.0054828143419306,27,45,49,8030,2409,561,20,8,0,1919,27,18,4
2020-12-15T12:47:22.445958,52.5384583333,13.374170000000001, none, sw,0.0054828143419306,28,50,55,8553,2624,596,29,8,0,1919,28,22,5
2020-12-15T12:47:23.461590,52.5384966667,13.374153333299999, none, sw,0.0054828143419306,28,50,55,8553,2624,596,29,8,0,1919,28,22,5
2020-12-15T12:47:24.479993,52.5385383333,13.3741333333, none, sw,0.0054828143419306,29,49,55,8738,2646,586,27,8,0,1919,29,20,6
2020-12-15T12:47:25.508338,52.5385683333,13.3741166667, none, sw,0.0054828143419306,29,50,54,8783,2649,596,25,6,0,1919,29,21,4
2020-12-15T12:47:27.529656,52.5386233333,13.3740316667, none, sw,0.0055620339613462,28,49,54,8732,2629,588,25,8,2,1919,28,21,5
2020-12-15T12:47:28.533597,52.5386233333,13.3740033333, none, sw,0.0055620339613462,28,49,56,8514,2594,578,34,10,4,1919,28,21,7
2020-12-15T12:47:29.555429,52.5386266667,13.3739833333, none, sw,0.0055620339613462,27,49,57,8529,2592,573,36,10,4,1919,27,22,8
2020-12-15T12:47:30.573008,52.5386616667,13.373968333299999, none, sw,0.0055620339613462,28,51,58,8523,2595,583,38,10,4,1919,28,23,7
2020-12-15T12:47:31.590569,52.5387016667,13.37396, none, sw,0.0055620339613462,26,50,55,8218,2415,565,34,6,4,1919,26,24,5
2020-12-15T12:47:32.609482,52.5387416667,13.373945, none, sw,0.0055620339613462,26,48,52,8030,2387,557,30,4,4,1919,26,22,4
2020-12-15T12:47:33.626260,52.5387766667,13.373923333299999, none, sw,0.0055620339613462,24,46,50,7731,2333,545,34,6,4,1919,24,22,4
2020-12-15T12:47:34.643191,52.5387883333,13.373923333299999, none, sw,0.0055620339613462,24,43,49,7528,2306,528,27,8,4,1919,24,19,6
2020-12-15T12:47:35.664470,52.53879499999999,13.3739333333, none, sw,0.0028876310162086,23,42,48,7274,2126,525,29,8,4,1919,23,19,6
2020-12-15T12:47:36.681942,52.538783333299996,13.3739383333, none, sw,0.0028876310162086,22,40,46,7035,2094,375,29,8,4,1919,22,18,6
2020-12-15T12:47:37.699653,52.5387983333,13.37394, none, sw,0.0028876310162086,22,41,46,7011,2089,370,29,8,2,1919,22,19,5
2020-12-15T12:47:38.717024,52.5388133333,13.373945, none, sw,0.0028876310162086,22,41,46,7011,2089,370,29,8,2,1919,22,19,5
2020-12-15T12:47:39.733748,52.538835,13.37396, none, sw,0.0028876310162086,22,38,43,6996,2080,370,20,6,0,1919,22,16,5
2020-12-15T12:47:40.751657,52.53885,13.373973333299999, none, sw,0.0028876310162086,22,38,43,6996,2080,370,20,6,0,1919,22,16,5
2020-12-15T12:47:41.768978,52.53885,13.373971666700001, none, sw,0.0028876310162086,23,37,41,6981,2072,372,16,6,0,1919,23,14,4
2020-12-15T12:47:42.786296,52.5388516667,13.373971666700001, none, sw,0.0028876310162086,23,37,41,6981,2072,372,16,6,0,1919,23,14,4
2020-12-15T12:47:43.804504,52.5388666667,13.373973333299999, none, se,0.0012022248207826,20,34,38,6682,1884,347,14,6,0,1919,20,14,4
2020-12-15T12:47:44.822114,52.5388883333,13.373963333299999, none, se,0.0012022248207826,21,34,37,6697,1887,345,16,6,0,1919,21,13,3
2020-12-15T12:47:45.839106,52.538915,13.3739466667, none, se,0.0012022248207826,22,35,38,6921,1910,343,18,6,0,1919,22,13,3
2020-12-15T12:47:46.855813,52.5389466667,13.3739333333, none, se,0.0012022248207826,23,36,38,7220,2075,345,14,4,0,1919,23,13,2
2020-12-15T12:47:47.875331,52.53898,13.373923333299999, none, se,0.0012022248207826,23,36,37,7274,2090,350,14,2,0,1919,23,13,1
2020-12-15T12:47:48.887893,52.5390216667,13.373913333299999, none, se,0.0012022248207826,24,39,42,7740,2160,378,16,4,0,1919,24,15,3
2020-12-15T12:47:49.907969,52.5390616667,13.373916666700001, none, se,0.0012022248207826,24,40,43,7770,2308,528,21,4,0,1919,24,16,3
2020-12-15T12:47:50.923979,52.539115,13.373915, none, se,0.0012022248207826,24,42,43,7749,2313,531,19,2,0,1919,24,18,1
2020-12-15T12:47:51.941834,52.5391683333,13.373915, none, s,0.0048249940650403,24,40,43,7719,2167,529,23,4,0,1919,24,16,3
2020-12-15T12:47:52.964098,52.539225,13.3739033333, none, s,0.0048249940650403,23,40,43,7474,2133,529,23,4,0,1919,23,17,3
2020-12-15T12:47:53.982250,52.53926,13.3738933333, none, s,0.0048249940650403,23,43,45,7504,2148,562,27,4,0,1919,23,20,2
2020-12-15T12:47:55.004481,52.5393033333,13.3738866667, none, s,0.0048249940650403,23,45,48,7704,2165,569,32,6,0,1919,23,22,3
2020-12-15T12:47:56.021080,52.5393333333,13.373871666700001, none, s,0.0048249940650403,23,44,47,7465,2142,571,32,6,0,1919,23,21,3
2020-12-15T12:47:57.037455,52.539334999999994,13.3738633333, none, s,0.0048249940650403,23,44,47,7465,2142,571,32,6,0,1919,23,21,3
2020-12-15T12:47:58.054173,52.5393583333,13.3738466667, none, s,0.0048249940650403,22,43,47,7181,2100,574,32,6,0,1919,22,21,4
2020-12-15T12:47:59.070724,52.5393766667,13.373854999999999, none, s,0.0033597560096972,22,43,47,7181,2100,574,32,6,0,1919,22,21,4
2020-12-15T12:48:00.087821,52.5393983333,13.37386, none, s,0.0033597560096972,22,43,46,6999,2087,556,34,6,0,1919,22,21,3
2020-12-15T12:48:01.104762,52.5394516667,13.373845000000001, none, s,0.0033597560096972,22,43,46,6999,2087,556,34,6,0,1919,22,21,3
2020-12-15T12:48:02.124643,52.5395133333,13.3738083333, none, s,0.0033597560096972,22,42,44,7029,2097,541,30,4,0,1919,22,20,2
2020-12-15T12:48:03.138597,52.5395683333,13.37379, none, s,0.0033597560096972,22,42,44,7029,2097,541,30,4,0,1919,22,20,2
2020-12-15T12:48:04.153868,52.5396216667,13.3737683333, none, s,0.0033597560096972,23,42,44,7274,2121,526,25,4,0,1919,23,19,2
2020-12-15T12:48:05.173968,52.53966,13.373755, none, s,0.0033597560096972,23,42,44,7274,2121,526,25,4,0,1919,23,19,2
2020-12-15T12:48:06.190165,52.539694999999995,13.3737466667, none, s,0.0033597560096972,22,42,44,7280,2118,528,23,4,0,1919,22,20,2
2020-12-15T12:48:07.208661,52.5397316667,13.373738333299999, none, s,0.0057507184580511,22,42,44,7280,2118,528,23,4,0,1919,22,20,2
2020-12-15T12:48:08.223280,52.5397433333,13.373731666700001, none, s,0.0057507184580511,24,42,44,7504,2160,525,19,2,0,1919,24,18,2
2020-12-15T12:48:09.239895,52.5397366667,13.3737183333, none, s,0.0057507184580511,24,42,44,7504,2160,525,19,2,0,1919,24,18,2
2020-12-15T12:48:10.255633,52.5397583333,13.3737066667, none, s,0.0057507184580511,24,43,46,7540,2175,523,26,6,2,1919,24,19,3
2020-12-15T12:48:11.272541,52.5397583333,13.373695000000001, none, s,0.0057507184580511,24,43,46,7540,2175,523,26,6,2,1919,24,19,3
2020-12-15T12:48:12.288335,52.5397766667,13.373683333299999, none, s,0.0057507184580511,24,44,49,7764,2330,382,31,8,2,1919,24,20,5
2020-12-15T12:48:13.304582,52.5398083333,13.373678333299999, none, s,0.0057507184580511,24,44,49,7764,2330,382,31,8,2,1919,24,20,5
2020-12-15T12:48:14.320715,52.539825,13.373675, none, s,0.0057507184580511,24,44,47,7794,2342,518,26,6,2,1919,24,20,3
2020-12-15T12:48:15.345772,52.5398483333,13.37367, none, sw,0.0019673117504602,24,44,47,7794,2342,518,26,6,2,1919,24,20,3
2020-12-15T12:48:16.345481,52.5398933333,13.3736683333, none, sw,0.0019673117504602,24,42,47,7713,2315,380,26,8,2,1919,24,18,5
2020-12-15T12:48:17.374625,52.5399433333,13.3736633333, none, sw,0.0019673117504602,24,40,46,7531,2305,365,26,8,2,1919,24,16,6
2020-12-15T12:48:18.395111,52.53995,13.37367, none, sw,0.0019673117504602,23,42,48,7501,2163,380,31,10,2,1919,23,19,6
2020-12-15T12:48:19.410870,52.5399433333,13.373675, none, sw,0.0019673117504602,22,40,47,7238,2118,372,33,10,2,1919,22,18,7
2020-12-15T12:48:20.426982,52.5399566667,13.373683333299999, none, sw,0.0019673117504602,22,39,47,7005,2101,362,33,12,2,1919,22,17,8
2020-12-15T12:48:21.444119,52.5399866667,13.373693333299999, none, sw,0.0019673117504602,22,38,47,6975,2089,355,35,14,2,1919,22,16,9
2020-12-15T12:48:22.460609,52.5400233333,13.37369, none, sw,0.0019673117504602,22,37,46,6781,2069,350,35,14,2,1919,22,15,9
2020-12-15T12:48:23.477679,52.5400716667,13.373686666700001, none, s,0.0035512991052632,22,39,46,6999,2093,360,35,10,0,1919,22,17,7
2020-12-15T12:48:24.494387,52.540105000000004,13.3736733333, none, s,0.0035512991052632,22,38,43,6939,2076,360,28,8,0,1919,22,16,5
2020-12-15T12:48:25.510911,52.540148333299996,13.3736666667, none, s,0.0035512991052632,22,37,43,6715,2054,352,28,8,0,1919,22,15,6
2020-12-15T12:48:27.533317,52.540275,13.373635, none, s,0.0035512991052632,22,37,42,6736,2059,352,26,6,0,1919,22,15,5
2020-12-15T12:48:28.551285,52.540315,13.3736216667, none, s,0.0035512991052632,22,39,43,6775,2076,372,30,6,0,1919,22,17,4
2020-12-15T12:48:29.570924,52.5403533333,13.3736183333, none, s,0.0035512991052632,23,38,42,6933,2088,372,23,6,0,1919,23,15,4
2020-12-15T12:48:30.592080,52.5403783333,13.3736133333, none, s,0.0035512991052632,23,38,42,6933,2088,372,23,6,0,1919,23,15,4
2020-12-15T12:48:31.613884,52.5403983333,13.373610000000001, none, s,0.00524169255489,23,37,43,6769,2081,372,23,8,2,1919,23,14,6
2020-12-15T12:48:32.630871,52.54043000000001,13.3736083333, none, s,0.00524169255489,23,37,43,6769,2081,372,23,8,2,1919,23,14,6
2020-12-15T12:48:33.647630,52.5404733333,13.373605, none, s,0.00524169255489,22,38,44,6778,2074,518,23,8,2,1919,22,16,6
2020-12-15T12:48:34.665210,52.540515,13.373596666700001, none, s,0.00524169255489,22,38,44,6778,2074,518,23,8,2,1919,22,16,6
2020-12-15T12:48:35.681420,52.5405516667,13.3735733333, none, s,0.00524169255489,23,38,43,6772,2077,382,21,6,2,1919,23,15,5
2020-12-15T12:48:36.698542,52.540580000000006,13.37354, none, s,0.00524169255489,23,38,43,6772,2077,382,21,6,2,1919,23,15,5
2020-12-15T12:48:37.716019,52.540625,13.3735283333, none, s,0.00524169255489,24,39,44,7208,2125,530,23,6,2,1919,24,15,5
2020-12-15T12:48:38.733380,52.54065500000001,13.373529999999999, none, s,0.00524169255489,23,37,40,6990,2088,517,16,6,2,1919,23,14,3
2020-12-15T12:48:39.749685,52.5406766667,13.3735316667, none, s,0.0044856197893231,24,42,47,7456,2148,542,26,8,2,1919,24,18,5
2020-12-15T12:48:40.765621,52.5406983333,13.3735283333, none, s,0.0044856197893231,25,40,46,7546,2165,537,24,8,2,1919,25,15,6
2020-12-15T12:48:41.782572,52.5407333333,13.3735333333, none, s,0.0044856197893231,25,43,49,7734,2306,552,28,10,2,1919,25,18,6
2020-12-15T12:48:42.799391,52.54075,13.373535, none, s,0.0044856197893231,25,42,48,7776,2311,532,26,10,2,1919,25,17,6
2020-12-15T12:48:43.814214,52.5407783333,13.37354, none, s,0.0044856197893231,24,42,48,7695,2153,530,31,10,2,1919,24,18,6
2020-12-15T12:48:44.830740,52.54081,13.373536666700002, none, s,0.0044856197893231,25,44,49,7806,2320,543,29,8,0,1919,25,19,5
2020-12-15T12:48:45.846421,52.5408583333,13.3735283333, none, s,0.0044856197893231,25,45,49,8030,2329,538,31,8,0,1919,25,20,4
2020-12-15T12:48:46.862281,52.5408966667,13.373529999999999, none, s,0.0044856197893231,25,46,53,8209,2351,553,35,10,2,1919,25,21,7
2020-12-15T12:48:47.878108,52.540925,13.3735333333, none, s,0.0039448012404740005,24,46,55,7961,2321,556,37,12,4,1919,24,22,9
2020-12-15T12:48:48.894031,52.540944999999994,13.37354, none, s,0.0039448012404740005,24,47,57,7991,2341,554,41,14,4,1919,24,23,10
2020-12-15T12:48:49.910801,52.540955000000004,13.373536666700002, none, s,0.0039448012404740005,23,43,50,7510,2153,532,29,12,4,1919,23,20,7
2020-12-15T12:48:50.926147,52.5409916667,13.3735216667, none, s,0.0039448012404740005,23,43,50,7510,2153,532,29,12,4,1919,23,20,7
2020-12-15T12:48:51.942052,52.5410583333,13.3735066667, none, s,0.0039448012404740005,23,43,51,7495,2153,540,31,12,4,1919,23,20,8
2020-12-15T12:48:52.958352,52.541133333299996,13.373508333299998, none, s,0.0039448012404740005,23,43,51,7495,2153,540,31,12,4,1919,23,20,8
2020-12-15T12:48:53.974271,52.5412016667,13.373515, none, s,0.0039448012404740005,24,42,48,7486,2157,518,27,10,4,1919,24,18,6
2020-12-15T12:48:54.991014,52.5412533333,13.3735216667, none, s,0.0039448012404740005,24,42,48,7486,2157,518,27,10,4,1919,24,18,6
2020-12-15T12:48:56.007086,52.5412983333,13.373525, none, s,0.0059309407730553,23,40,47,7271,2122,520,25,10,4,1919,23,17,7
2020-12-15T12:48:57.023969,52.5413483333,13.3735233333, none, s,0.0059309407730553,23,40,47,7271,2122,520,25,10,4,1919,23,17,7
2020-12-15T12:48:58.042975,52.5414066667,13.3735216667, none, s,0.0059309407730553,24,42,48,7474,2154,525,27,10,4,1919,24,18,6
2020-12-15T12:48:59.058170,52.5414583333,13.3735283333, none, s,0.0059309407730553,23,42,50,7292,2129,512,36,12,4,1919,23,19,8
2020-12-15T12:49:00.072643,52.541495,13.373538333299999, none, s,0.0059309407730553,23,43,53,7226,2134,512,41,14,6,1919,23,20,10
2020-12-15T12:49:01.093653,52.5415183333,13.373546666700001, none, s,0.0059309407730553,23,43,50,7181,2109,377,41,12,4,1919,23,20,7
2020-12-15T12:49:02.109852,52.5415383333,13.373565, none, s,0.0059309407730553,23,42,48,7172,2109,367,39,10,2,1919,23,19,6
2020-12-15T12:49:03.126597,52.541556666700004,13.3735716667, none, s,0.0041282989462677,22,42,47,6999,2089,512,39,8,2,1919,22,20,5
2020-12-15T12:49:04.142582,52.54159,13.373575, none, s,0.0041282989462677,23,43,48,7187,2104,524,41,8,2,1919,23,20,5
2020-12-15T12:49:05.160015,52.5416233333,13.3735766667, none, s,0.0041282989462677,23,43,49,7247,2119,521,41,10,2,1919,23,20,6
2020-12-15T12:49:06.176127,52.5416583333,13.373579999999999, none, s,0.0041282989462677,23,43,50,7277,2132,541,41,10,2,1919,23,20,7
2020-12-15T12:49:07.193786,52.5417083333,13.37359, none, s,0.0041282989462677,24,47,53,7516,2310,561,48,10,2,1919,24,23,6
2020-12-15T12:49:08.213989,52.5417583333,13.373605, none, s,0.0041282989462677,24,46,51,7471,2160,558,41,8,2,1919,24,22,5
2020-12-15T12:49:09.237106,52.5418,13.373625, none, s,0.0041282989462677,24,46,49,7501,2160,573,34,6,2,1919,24,22,3
2020-12-15T12:49:10.255391,52.5418416667,13.373643333299999, none, s,0.0041282989462677,25,47,48,7719,2316,575,25,2,0,1919,25,22,1
2020-12-15T12:49:11.267715,52.5418866667,13.373655, none, s,0.0053035081732341,25,47,48,7719,2316,575,25,2,0,1919,25,22,1
2020-12-15T12:49:12.291970,52.541909999999994,13.3736583333, none, s,0.0053035081732341,26,47,50,8012,2358,587,25,6,0,1919,26,21,3
2020-12-15T12:49:13.312487,52.54195,13.373660000000001, none, s,0.0053035081732341,26,46,49,8012,2358,587,25,6,0,1919,26,20,3
2020-12-15T12:49:14.329178,52.5419816667,13.3736683333, none, s,0.0053035081732341,24,46,49,7961,2338,594,23,6,0,1919,24,22,3
2020-12-15T12:49:15.347321,52.5420166667,13.3736716667, none, s,0.0053035081732341,24,46,49,7961,2338,594,23,6,0,1919,24,22,3
2020-12-15T12:49:16.350135,52.5420466667,13.373664999999999, none, s,0.0053035081732341,25,44,48,7997,2341,579,21,6,0,1919,25,19,4
2020-12-15T12:49:17.371862,52.542073333299996,13.373660000000001, none, s,0.0053035081732341,25,44,48,7997,2341,579,21,6,0,1919,25,19,4
2020-12-15T12:49:18.391561,52.542116666700004,13.3736683333, none, s,0.0053035081732341,24,42,47,7937,2326,559,19,6,0,1919,24,18,5
2020-12-15T12:49:19.413495,52.54215,13.373683333299999, none, s,0.0041919659904802,24,42,47,7937,2326,559,19,6,0,1919,24,18,5
2020-12-15T12:49:20.430860,52.5421833333,13.373688333299999, none, s,0.0041919659904802,24,44,49,7770,2306,554,24,6,2,1919,24,20,5
2020-12-15T12:49:21.448026,52.54221,13.373683333299999, none, s,0.0041919659904802,24,45,49,7770,2308,554,28,6,2,1919,24,21,4
2020-12-15T12:49:22.464457,52.5422333333,13.373685, none, s,0.0041919659904802,23,43,47,7537,2145,557,25,6,2,1919,23,20,4
2020-12-15T12:49:23.482134,52.5422383333,13.373688333299999, none, s,0.0041919659904802,23,44,48,7501,2143,550,30,6,2,1919,23,21,4
2020-12-15T12:49:24.499552,52.5422566667,13.373678333299999, none, s,0.0041919659904802,23,44,48,7540,2163,540,30,6,2,1919,23,21,4
2020-12-15T12:49:25.516182,52.5422566667,13.3736683333, none, s,0.0041919659904802,23,43,47,7495,2140,538,30,6,2,1919,23,20,4
2020-12-15T12:49:27.520417,52.5422733333,13.3736516667, none, s,0.0019828638640201,22,43,46,7211,2101,528,33,4,4,1919,22,21,3
2020-12-15T12:49:28.542749,52.542280000000005,13.3736566667, none, s,0.0019828638640201,22,42,45,6963,2071,375,35,4,4,1919,22,20,3
2020-12-15T12:49:29.559676,52.5423383333,13.373646666700001, none, s,0.0019828638640201,21,39,45,6694,1913,370,35,6,6,1919,21,18,6
2020-12-15T12:49:30.575888,52.54239499999999,13.373631666700001, none, s,0.0019828638640201,21,41,47,6664,1903,513,42,8,6,1919,21,20,6
2020-12-15T12:49:31.593058,52.542433333299996,13.3736266667, none, s,0.0019828638640201,21,40,45,6515,1903,518,37,6,4,1919,21,19,5
2020-12-15T12:49:32.611444,52.542465,13.373635, none, s,0.0019828638640201,19,38,43,6434,1866,380,33,6,4,1919,19,19,5
2020-12-15T12:49:33.628469,52.5424933333,13.373645000000002, none, s,0.0019828638640201,19,37,44,6479,1871,380,31,8,4,1919,19,18,7
2020-12-15T12:49:34.633266,52.542515,13.373648333299998, none, s,0.0019828638640201,19,37,44,6479,1871,380,31,8,4,1919,19,18,7
2020-12-15T12:49:35.650214,52.542545,13.3736516667, none, s,0.0043154183543249,21,36,43,6658,1888,377,26,10,4,1919,21,15,7
2020-12-15T12:49:36.656942,52.54258000000001,13.3736566667, none, s,0.0043154183543249,21,36,43,6658,1888,377,26,10,4,1919,21,15,7
2020-12-15T12:49:37.678743,52.5426116667,13.3736516667, none, s,0.0043154183543249,20,35,41,6476,1873,375,26,10,4,1919,20,15,6
2020-12-15T12:49:38.696111,52.5426366667,13.373648333299998, none, s,0.0043154183543249,20,35,41,6476,1873,375,26,10,4,1919,20,15,6
2020-12-15T12:49:39.712787,52.5426466667,13.373645000000002, none, s,0.0043154183543249,20,36,45,6437,1868,518,33,12,4,1919,20,16,9
2020-12-15T12:49:40.729914,52.5426633333,13.37364, none, s,0.0043154183543249,20,36,45,6437,1868,518,33,12,4,1919,20,16,9
2020-12-15T12:49:41.746926,52.542694999999995,13.373635, none, s,0.0043154183543249,21,38,45,6503,1887,528,30,10,2,1919,21,17,7
2020-12-15T12:49:42.767593,52.542721666700004,13.373629999999999, none, s,0.0043154183543249,21,38,45,6503,1887,528,30,10,2,1919,21,17,7
2020-12-15T12:49:43.785053,52.5427516667,13.373629999999999, none, s,0.0032895499406204,21,37,44,6482,1885,531,28,10,2,1919,21,16,7
2020-12-15T12:49:44.802461,52.5427866667,13.373638333299999, none, s,0.0032895499406204,22,38,44,6679,1907,531,26,8,0,1919,22,16,6
2020-12-15T12:49:45.818114,52.542840000000005,13.373629999999999, none, s,0.0032895499406204,22,37,42,6715,2048,516,19,6,0,1919,22,15,5
2020-12-15T12:49:46.833733,52.5429083333,13.373635, none, s,0.0032895499406204,22,37,42,6512,1906,514,21,6,0,1919,22,15,5
2020-12-15T12:49:47.850012,52.542995,13.373646666700001, none, s,0.0032895499406204,21,37,41,6497,1901,514,21,6,0,1919,21,16,4
2020-12-15T12:49:48.865957,52.5430533333,13.3736666667, none, s,0.0032895499406204,22,38,41,6676,2054,383,21,4,0,1919,22,16,3
2020-12-15T12:49:49.883098,52.5431066667,13.373685, none, s,0.0032895499406204,22,38,42,6670,2049,383,21,4,2,1919,22,16,4
2020-12-15T12:49:50.901195,52.543144999999996,13.3737133333, none, s,0.0032895499406204,21,37,42,6461,1892,513,23,6,2,1919,21,16,5
2020-12-15T12:49:51.915151,52.5431716667,13.373738333299999, none, s,0.0067532874741048,20,35,37,6207,1853,360,16,4,2,1919,20,15,2
2020-12-15T12:49:52.935208,52.54319,13.3737666667, none, s,0.0067532874741048,19,32,35,5938,1811,345,14,4,2,1919,19,13,3
2020-12-15T12:49:53.946857,52.5432066667,13.373795000000001, none, s,0.0067532874741048,19,34,37,6162,1833,362,16,4,2,1919,19,15,3
2020-12-15T12:49:54.972267,52.543225,13.373821666700001, none, s,0.0067532874741048,19,34,38,6198,1843,367,18,6,2,1919,19,15,4
2020-12-15T12:49:55.993326,52.543175,13.373876666700001, none, s,0.0067532874741048,19,33,37,6162,1835,360,18,6,2,1919,19,14,4
2020-12-15T12:49:57.010372,52.5431816667,13.3739, none, s,0.0067532874741048,19,33,37,6162,1835,360,18,6,2,1919,19,14,4
2020-12-15T12:49:58.025802,52.5431866667,13.373918333299999, none, s,0.0067532874741048,19,32,36,5998,1825,362,14,6,2,1919,19,13,4
2020-12-15T12:49:59.042579,52.5432,13.3739366667, none, e,0.0019681997480171,19,32,36,5998,1825,362,14,6,2,1919,19,13,4
2020-12-15T12:50:00.057761,52.5432266667,13.3739516667, none, e,0.0019681997480171,19,32,36,5938,1810,352,14,6,2,1919,19,13,4
2020-12-15T12:50:01.073396,52.54326,13.373966666700001, none, e,0.0019681997480171,19,32,36,5938,1810,352,14,6,2,1919,19,13,4
2020-12-15T12:50:02.093333,52.5432916667,13.3739833333, none, e,0.0019681997480171,18,30,36,5923,1800,345,14,8,2,1919,18,12,6
2020-12-15T12:50:03.109571,52.5433216667,13.374006666700001, none, e,0.0019681997480171,18,30,36,5923,1800,345,14,8,2,1919,18,12,6
2020-12-15T12:50:04.125496,52.5433633333,13.3740266667, none, e,0.0019681997480171,18,30,37,5908,1655,348,21,10,0,1919,18,12,7
2020-12-15T12:50:05.143615,52.5433833333,13.374056666700001, none, e,0.0019681997480171,18,30,37,5908,1655,348,21,10,0,1919,18,12,7
2020-12-15T12:50:06.159048,52.5433933333,13.3740916667, none, e,0.0019681997480171,18,32,36,6013,1815,356,17,8,0,1919,18,14,4
2020-12-15T12:50:07.174361,52.5434016667,13.3741233333, none, se,0.0036761278649419,18,32,36,6013,1815,356,17,8,0,1919,18,14,4
2020-12-15T12:50:08.190852,52.54340500000001,13.37415, none, se,0.0036761278649419,19,34,39,6404,1859,376,19,8,0,1919,19,15,5
2020-12-15T12:50:09.206475,52.543415,13.3741733333, none, se,0.0036761278649419,19,34,39,6404,1859,376,19,8,0,1919,19,15,5
2020-12-15T12:50:10.225097,52.5434266667,13.374191666700002, none, se,0.0036761278649419,19,35,39,6449,1877,512,17,8,0,1919,19,16,4
2020-12-15T12:50:11.240330,52.5434366667,13.374206666700001, none, se,0.0036761278649419,19,35,39,6449,1877,512,17,8,0,1919,19,16,4
2020-12-15T12:50:12.258401,52.5434516667,13.3742266667, none, se,0.0036761278649419,21,34,38,6455,1875,369,15,8,0,1919,21,13,4
2020-12-15T12:50:13.273045,52.5434766667,13.374248333299999, none, se,0.0036761278649419,21,34,38,6455,1875,369,15,8,0,1919,21,13,4
2020-12-15T12:50:14.290760,52.5434916667,13.3742666667, none, se,0.0036761278649419,21,33,37,6491,1885,359,13,6,0,1919,21,12,4
2020-12-15T12:50:15.310193,52.543515,13.374275, none, se,0.0023211552575398,21,33,37,6491,1885,359,13,6,0,1919,21,12,4
2020-12-15T12:50:16.332886,52.543544999999995,13.3742716667, none, se,0.0023211552575398,22,35,38,6724,1910,374,13,6,0,1919,22,13,3
2020-12-15T12:50:17.349938,52.54356,13.374256666700001, none, se,0.0023211552575398,22,35,38,6724,1910,374,13,6,0,1919,22,13,3
2020-12-15T12:50:18.367494,52.543575,13.3742283333, none, se,0.0023211552575398,21,34,37,6527,1877,362,13,6,0,1919,21,13,3
2020-12-15T12:50:19.384460,52.5435816667,13.374204999999998, none, se,0.0023211552575398,20,35,38,6694,1885,379,15,6,0,1919,20,15,3
2020-12-15T12:50:20.402951,52.543573333299996,13.374189999999999, none, se,0.0023211552575398,21,37,39,6724,1897,527,15,4,0,1919,21,16,2
2020-12-15T12:50:21.420567,52.54355,13.3741866667, none, se,0.0023211552575398,20,37,37,6527,1889,529,8,0,0,1919,20,17,0
2020-12-15T12:50:22.438711,52.5435066667,13.3741833333, none, se,0.0023211552575398,21,35,35,6401,1847,376,10,0,0,1919,21,14,0
2020-12-15T12:50:23.464444,52.5434666667,13.374195, none, nw,0.001089458045307,20,33,33,6147,1805,361,12,0,0,1919,20,13,0
2020-12-15T12:50:24.484639,52.5434883333,13.3742233333, none, nw,0.001089458045307,18,33,34,5959,1659,356,14,2,0,1919,18,15,1
2020-12-15T12:50:25.501925,52.543525,13.374245000000002, none, nw,0.001089458045307,17,32,33,5735,1634,359,14,2,0,1919,17,15,1
2020-12-15T12:50:26.521135,52.54360500000001,13.3742733333, none, nw,0.001089458045307,17,32,33,5684,1614,372,14,2,0,1919,17,15,1
2020-12-15T12:50:28.538336,52.5436983333,13.37435, none, nw,0.001089458045307,16,33,34,5436,1587,382,18,2,0,1919,16,17,1
2020-12-15T12:50:29.556705,52.54371999999999,13.3743716667, none, nw,0.001089458045307,16,35,36,5669,1622,515,20,2,0,1919,16,19,1
2020-12-15T12:50:30.582248,52.543780000000005,13.374393333299999, none, nw,0.001089458045307,17,36,39,5908,1792,528,20,4,2,1919,17,19,3
2020-12-15T12:50:31.590898,52.54383000000001,13.3744183333, none, se,0.0061616218978865,17,35,39,5923,1795,520,22,6,2,1919,17,18,4
2020-12-15T12:50:32.612206,52.54387,13.374436666700001, none, se,0.0061616218978865,17,35,39,5923,1795,520,22,6,2,1919,17,18,4
2020-12-15T12:50:33.629643,52.5439066667,13.37445, none, se,0.0061616218978865,17,35,41,5953,1798,528,22,8,2,1919,17,18,6
2020-12-15T12:50:34.646324,52.5439483333,13.374464999999999, none, se,0.0061616218978865,18,36,42,6004,1823,538,20,8,2,1919,18,18,6
2020-12-15T12:50:35.663462,52.543996666700004,13.374481666700001, none, se,0.0061616218978865,19,36,42,6243,1848,533,16,8,2,1919,19,17,6
2020-12-15T12:50:36.680730,52.5440583333,13.374493333299998, none, se,0.0061616218978865,19,39,45,6679,1893,545,26,8,2,1919,19,20,6
2020-12-15T12:50:37.698968,52.5441133333,13.3745183333, none, se,0.0061616218978865,21,39,45,6763,1915,542,26,8,2,1919,21,18,6
2020-12-15T12:50:38.716174,52.5441633333,13.3745516667, none, se,0.0061616218978865,22,44,52,6966,2073,572,38,10,4,1919,22,22,8
2020-12-15T12:50:39.734144,52.544205000000005,13.374578333299999, none, se,0.0061541395859134,22,45,54,7169,2092,574,43,12,6,1919,22,23,9
2020-12-15T12:50:40.753775,52.544235,13.374604999999999, none, se,0.0061541395859134,22,44,53,6996,2080,569,43,12,6,1919,22,22,9
2020-12-15T12:50:41.771906,52.54427,13.374616666700001, none, se,0.0061541395859134,21,42,49,6742,1917,539,43,10,4,1919,21,21,7
2020-12-15T12:50:42.788014,52.544305,13.374621666700001, none, se,0.0061541395859134,21,39,46,6691,1895,517,39,8,4,1919,21,18,7
2020-12-15T12:50:43.803908,52.544313333299996,13.374629999999998, none, se,0.0061541395859134,22,40,45,6730,1912,381,39,6,4,1919,22,18,5
2020-12-15T12:50:44.821344,52.5443283333,13.374628333299999, none, se,0.0061541395859134,22,42,47,6745,1914,516,43,8,4,1919,22,20,5
2020-12-15T12:50:45.837863,52.5443466667,13.374614999999999, none, se,0.0061541395859134,21,40,47,6497,1887,518,45,8,4,1919,21,19,7
2020-12-15T12:50:46.853889,52.5443683333,13.3745933333, none, se,0.0061541395859134,21,41,47,6497,1887,518,45,8,4,1919,21,20,6
2020-12-15T12:50:47.870483,52.544380000000004,13.3745616667, none, s,0.0027845118689177,19,37,43,6198,1837,375,33,6,4,1919,19,18,6
2020-12-15T12:50:48.887156,52.5444066667,13.3745466667, none, s,0.0027845118689177,19,37,43,6198,1837,375,33,6,4,1919,19,18,6
2020-12-15T12:50:49.903982,52.544423333299996,13.374536666700001, none, s,0.0027845118689177,19,39,45,6225,1852,518,40,8,4,1919,19,20,6
2020-12-15T12:50:50.919984,52.544430000000006,13.374528333299999, none, s,0.0027845118689177,19,36,39,6186,1842,365,30,6,2,1919,19,17,3
2020-12-15T12:50:51.936655,52.5444333333,13.3745083333, none, s,0.0027845118689177,18,34,36,5998,1820,348,23,4,0,1919,18,16,2
2020-12-15T12:50:52.952704,52.5444616667,13.374485, none, s,0.0027845118689177,18,35,37,5983,1822,355,28,4,0,1919,18,17,2
2020-12-15T12:50:53.969061,52.544495,13.3744633333, none, s,0.0027845118689177,18,36,38,6183,1842,372,28,4,0,1919,18,18,2
2020-12-15T12:50:54.986005,52.544540000000005,13.374435, none, s,0.0027845118689177,18,37,41,6147,1844,525,30,4,0,1919,18,19,4
2020-12-15T12:50:56.002752,52.5445683333,13.374425, none, sw,0.0032700338732041,18,37,41,5995,1839,518,32,4,0,1919,18,19,4
2020-12-15T12:50:57.019257,52.5445833333,13.374426666700002, none, sw,0.0032700338732041,18,37,42,5944,1829,513,35,6,4,1919,18,19,5
2020-12-15T12:50:58.035265,52.544605000000004,13.374435, none, sw,0.0032700338732041,18,38,43,6153,1849,523,35,6,4,1919,18,20,5
2020-12-15T12:50:59.051521,52.5446316667,13.374443333299999, none, sw,0.0032700338732041,18,41,45,6264,1882,526,42,6,4,1919,18,23,4
2020-12-15T12:51:00.069147,52.544648333299996,13.3744516667, none, sw,0.0032700338732041,18,39,44,6401,1872,516,39,6,4,1919,18,21,5
2020-12-15T12:51:01.085227,52.54465,13.3744633333, none, sw,0.0032700338732041,18,38,43,6216,1852,375,37,6,4,1919,18,20,5
2020-12-15T12:51:02.101108,52.5446566667,13.374481666700001, none, sw,0.0032700338732041,19,41,46,6455,1897,518,42,8,6,1919,19,22,5
2020-12-15T12:51:03.117956,52.544635,13.374505, none, se,0.0013109800798174,21,40,46,6664,2050,533,35,8,6,1919,21,19,6
2020-12-15T12:51:04.133869,52.5446066667,13.374536666700001, none, se,0.0013109800798174,19,39,46,6524,1915,523,35,8,6,1919,19,20,7
2020-12-15T12:51:05.151216,52.5445966667,13.374573333299999, none, se,0.0013109800798174,19,39,46,6524,1915,523,35,8,6,1919,19,20,7
2020-12-15T12:51:06.167699,52.544601666700004,13.3746083333, none, se,0.0013109800798174,21,39,46,6688,2051,380,33,8,6,1919,21,18,7
2020-12-15T12:51:07.183669,52.544603333299996,13.37464, none, se,0.0013109800798174,21,39,46,6688,2051,380,33,8,6,1919,21,18,7
2020-12-15T12:51:08.200289,52.5446333333,13.3746633333, none, se,0.0013109800798174,21,39,45,6688,1916,520,29,8,6,1919,21,18,6
2020-12-15T12:51:09.216229,52.544691666700004,13.374671666700001, none, se,0.0013109800798174,21,39,45,6688,1916,520,29,8,6,1919,21,18,6
2020-12-15T12:51:10.233334,52.54473,13.374683333299998, none, se,0.0013109800798174,21,38,43,6724,2054,513,24,6,2,1919,21,17,5
2020-12-15T12:51:11.249603,52.5447666667,13.374685000000001, none, se,0.0027199874943605,21,38,43,6724,2054,513,24,6,2,1919,21,17,5
2020-12-15T12:51:12.266315,52.54478,13.3747, none, se,0.0027199874943605,22,38,44,6769,2076,513,26,8,2,1919,22,16,6
2020-12-15T12:51:13.281800,52.5448083333,13.3746933333, none, se,0.0027199874943605,22,38,44,6769,2076,513,26,8,2,1919,22,16,6
2020-12-15T12:51:14.297906,52.54485,13.3746816667, none, se,0.0027199874943605,21,36,43,6521,1918,380,21,10,2,1919,21,15,7
2020-12-15T12:51:15.314431,52.5448683333,13.374678333299999, none, se,0.0027199874943605,21,36,43,6521,1918,380,21,10,2,1919,21,15,7
2020-12-15T12:51:16.330767,52.544885,13.37468, none, se,0.0027199874943605,21,35,41,6440,1898,380,17,8,2,1919,21,14,6
2020-12-15T12:51:17.347107,52.5449066667,13.37468, none, se,0.0027199874943605,21,35,41,6440,1898,380,17,8,2,1919,21,14,6
2020-12-15T12:51:18.365201,52.5450166667,13.374631666700001, none, se,0.0027199874943605,19,35,43,6470,1896,378,19,10,4,1919,19,16,8
2020-12-15T12:51:19.382409,52.545069999999996,13.374588333299998, none, s,0.0049081059997913,19,35,43,6470,1896,378,19,10,4,1919,19,16,8
2020-12-15T12:51:20.403089,52.5450983333,13.37454, none, s,0.0049081059997913,18,33,38,6201,1851,363,12,8,2,1919,18,15,5
2020-12-15T12:51:21.419893,52.54513000000001,13.374483333299999, none, s,0.0049081059997913,18,33,38,6201,1851,363,12,8,2,1919,18,15,5
2020-12-15T12:51:22.438639,52.545159999999996,13.3744233333, none, s,0.0049081059997913,18,32,37,6195,1836,353,14,8,2,1919,18,14,5
2020-12-15T12:51:23.455423,52.5451833333,13.3743766667, none, s,0.0049081059997913,18,32,37,6195,1836,353,14,8,2,1919,18,14,5
2020-12-15T12:51:24.478019,52.545208333299996,13.3743116667, none, s,0.0049081059997913,19,32,37,6207,1838,356,12,8,2,1919,19,13,5
2020-12-15T12:51:25.489245,52.5452333333,13.374243333299999, none, s,0.0049081059997913,19,32,37,6207,1838,356,12,8,2,1919,19,13,5
2020-12-15T12:51:26.514767,52.5452583333,13.374201666700001, none, s,0.0049081059997913,18,29,35,5983,1805,351,12,8,2,1919,18,11,6
2020-12-15T12:51:28.531803,52.545390000000005,13.374020000000002, none, sw,0.0074820746790614,18,29,35,5983,1805,351,12,8,2,1919,18,11,6
2020-12-15T12:51:29.548666,52.545425,13.3739916667, none, sw,0.0074820746790614,19,30,36,6186,1832,351,12,8,2,1919,19,11,6
2020-12-15T12:51:30.566703,52.545435,13.373975, none, sw,0.0074820746790614,19,30,36,6186,1832,351,12,8,2,1919,19,11,6
2020-12-15T12:51:31.585740,52.545444999999994,13.373965, none, sw,0.0074820746790614,18,32,36,6231,1837,363,10,6,2,1919,18,14,4
2020-12-15T12:51:32.602497,52.545451666700004,13.373956666700002, none, sw,0.0074820746790614,18,32,36,6231,1837,363,10,6,2,1919,18,14,4
2020-12-15T12:51:33.619735,52.5454566667,13.37395, none, sw,0.0074820746790614,18,29,33,5977,1800,348,6,4,2,1919,18,11,4
2020-12-15T12:51:34.635919,52.54546,13.3739416667, none, sw,0.0074820746790614,18,32,35,6159,1815,368,13,2,2,1919,18,14,3
2020-12-15T12:51:35.652650,52.5454566667,13.3739433333, none, sw,0.0074820746790614,18,33,36,6240,1847,376,15,2,2,1919,18,15,3
2020-12-15T12:51:36.669684,52.54545,13.3739366667, none, sw,0.0012475736352135,19,33,37,6210,1842,516,17,4,0,1919,19,14,4
2020-12-15T12:51:37.688002,52.5454283333,13.3739366667, none, sw,0.0012475736352135,19,33,36,6270,1842,513,17,4,0,1919,19,14,3
2020-12-15T12:51:38.704850,52.545390000000005,13.373915, none, sw,0.0012475736352135,20,34,39,6240,1845,373,22,6,2,1919,20,14,5
2020-12-15T12:51:39.723426,52.545405,13.373883333299998, none, sw,0.0012475736352135,20,35,40,6204,1838,368,26,6,2,1919,20,15,5
2020-12-15T12:51:40.740337,52.545469999999995,13.373823333299999, none, sw,0.0012475736352135,20,38,42,6413,1866,380,28,6,2,1919,20,18,4
2020-12-15T12:51:41.756664,52.5455383333,13.373721666700002, none, sw,0.0012475736352135,19,37,43,6404,1859,378,37,8,2,1919,19,18,6
2020-12-15T12:51:42.773170,52.5455983333,13.37364, none, sw,0.0012475736352135,19,37,42,6225,1844,371,37,8,2,1919,19,18,5
2020-12-15T12:51:43.791018,52.545655000000004,13.3735633333, none, sw,0.0012475736352135,19,37,44,6270,1856,381,39,10,2,1919,19,18,7
2020-12-15T12:51:44.811053,52.5457,13.373491666700001, none, sw,0.0058523619478335,19,36,44,6255,1851,371,34,12,2,1919,19,17,8
2020-12-15T12:51:45.827809,52.545735,13.373439999999999, none, sw,0.0058523619478335,18,35,43,6159,1814,371,32,12,2,1919,18,17,8
2020-12-15T12:51:46.848007,52.5457716667,13.373401666700001, none, sw,0.0058523619478335,18,35,43,6159,1814,371,32,12,2,1919,18,17,8
2020-12-15T12:51:47.873588,52.5457916667,13.3733866667, none, sw,0.0058523619478335,18,36,43,6189,1821,369,30,10,4,1919,18,18,7
2020-12-15T12:51:48.892601,52.545809999999996,13.373363333299999, none, sw,0.0058523619478335,18,36,43,6189,1821,369,30,10,4,1919,18,18,7
2020-12-15T12:51:49.914537,52.54584499999999,13.3733483333, none, sw,0.0058523619478335,18,36,43,6168,1819,377,30,10,4,1919,18,18,7
2020-12-15T12:51:50.931348,52.545865,13.3733266667, none, sw,0.0058523619478335,18,36,43,6168,1819,377,30,10,4,1919,18,18,7
2020-12-15T12:51:51.947329,52.5458916667,13.373306666700001, none, sw,0.0058523619478335,17,35,40,6010,1801,379,25,8,2,1919,17,18,5
2020-12-15T12:51:52.962964,52.5459066667,13.3732883333, none, sw,0.0038256422652685,17,35,40,6010,1801,379,25,8,2,1919,17,18,5
2020-12-15T12:51:53.981946,52.5459283333,13.373254999999999, none, sw,0.0038256422652685,18,36,42,6446,1845,519,21,8,2,1919,18,18,6
2020-12-15T12:51:55.003062,52.5459566667,13.373213333299999, none, sw,0.0038256422652685,18,36,41,6446,1845,519,21,8,2,1919,18,18,5
2020-12-15T12:51:56.019223,52.54599,13.373176666700001, none, sw,0.0038256422652685,19,35,43,6700,1867,522,21,10,4,1919,19,16,8
2020-12-15T12:51:57.035239,52.5460216667,13.373129999999998, none, sw,0.0038256422652685,19,35,43,6700,1867,522,21,10,4,1919,19,16,8
2020-12-15T12:51:58.051100,52.5460816667,13.373076666700001, none, sw,0.0038256422652685,22,37,44,7211,2074,547,12,8,4,1919,22,15,7
2020-12-15T12:51:59.067665,52.5461066667,13.373033333299999, none, sw,0.0038256422652685,23,42,48,7689,2134,574,19,10,4,1919,23,19,6
2020-12-15T12:52:00.084980,52.5461283333,13.372993333299998, none, sw,0.0045298308391343,24,43,48,7973,2307,574,19,8,4,1919,24,19,5
2020-12-15T12:52:01.102607,52.546144999999996,13.37296, none, sw,0.0045298308391343,24,45,51,8054,2327,579,27,10,4,1919,24,21,6
2020-12-15T12:52:02.122828,52.5461716667,13.372933333299999, none, sw,0.0045298308391343,26,48,55,8720,2414,594,29,10,4,1919,26,22,7
2020-12-15T12:52:03.144300,52.5461966667,13.3729, none, sw,0.0045298308391343,26,48,55,8732,2419,586,31,10,2,1919,26,22,7
2020-12-15T12:52:04.167210,52.546215000000004,13.3728733333, none, sw,0.0045298308391343,28,49,57,9046,2606,586,33,12,4,1919,28,21,8
2020-12-15T12:52:05.184603,52.546234999999996,13.3728516667, none, sw,0.0045298308391343,29,49,58,9249,2641,591,31,12,4,1919,29,20,9
2020-12-15T12:52:06.201709,52.5462566667,13.372841666700001, none, sw,0.0045298308391343,28,51,59,9052,2629,596,38,12,4,1919,28,23,8
2020-12-15T12:52:07.216718,52.546281666700004,13.3728283333, none, sw,0.0045298308391343,28,51,58,9007,2621,593,36,10,2,1919,28,23,7
2020-12-15T12:52:08.232632,52.5462883333,13.372815, none, sw,0.0030703901212546,27,49,56,8496,2421,573,40,10,2,1919,27,22,7
2020-12-15T12:52:09.250247,52.5463033333,13.372785, none, sw,0.0030703901212546,26,47,52,8039,2369,556,35,8,2,1919,26,21,5
2020-12-15T12:52:10.267209,52.5463233333,13.372746666700001, none, sw,0.0030703901212546,25,46,51,7791,2334,544,35,8,2,1919,25,21,5
2020-12-15T12:52:11.282386,52.5463583333,13.372710000000001, none, sw,0.0030703901212546,25,46,51,7791,2334,544,35,8,2,1919,25,21,5
2020-12-15T12:52:12.302015,52.5463733333,13.37266, none, sw,0.0030703901212546,25,44,47,7725,2324,531,25,4,2,1919,25,19,3
2020-12-15T12:52:13.317281,52.5463983333,13.372618333299998, none, sw,0.0030703901212546,25,44,47,7725,2324,531,25,4,2,1919,25,19,3
2020-12-15T12:52:14.332496,52.5464233333,13.3725766667, none, sw,0.0030703901212546,25,43,45,7471,2164,526,23,4,2,1919,25,18,2
2020-12-15T12:52:15.356190,52.546445,13.3725433333, none, sw,0.0030703901212546,25,43,45,7471,2164,526,23,4,2,1919,25,18,2
2020-12-15T12:52:16.372858,52.5464683333,13.372516666700001, none, sw,0.0040596494095472,25,43,46,7480,2309,529,21,4,4,1919,25,18,3
2020-12-15T12:52:17.390986,52.546475,13.372504999999999, none, sw,0.0040596494095472,25,43,46,7480,2309,529,21,4,4,1919,25,18,3
2020-12-15T12:52:18.409427,52.5464766667,13.3724966667, none, sw,0.0040596494095472,23,42,43,7029,2117,526,19,2,2,1919,23,19,1
2020-12-15T12:52:19.414449,52.54648,13.3724866667, none, sw,0.0040596494095472,23,42,43,7029,2117,526,19,2,2,1919,23,19,1
2020-12-15T12:52:20.433976,52.546481666700004,13.3724816667, none, sw,0.0040596494095472,24,42,45,7208,2132,536,21,4,4,1919,24,18,3
2020-12-15T12:52:21.453607,52.546481666700004,13.372475, none, sw,0.0040596494095472,24,42,45,7208,2132,536,21,4,4,1919,24,18,3
2020-12-15T12:52:22.470529,52.546481666700004,13.372470000000002, none, sw,0.0040596494095472,23,39,43,6948,2090,516,14,4,4,1919,23,16,4
2020-12-15T12:52:23.488879,52.5464966667,13.372456666700002, none, sw,0.0040596494095472,23,39,44,6775,2083,514,18,4,4,1919,23,16,5
2020-12-15T12:52:24.505901,52.5465116667,13.3724416667, none, sw,0.00099937755774638,22,38,45,6748,2076,516,18,8,8,1919,22,16,7
2020-12-15T12:52:26.521354,52.54654,13.37241, none, sw,0.00099937755774638,22,37,44,6748,2078,373,18,8,8,1919,22,15,7
2020-12-15T12:52:27.541832,52.5465466667,13.3724, none, sw,0.00099937755774638,22,39,46,6778,2076,521,23,8,8,1919,22,17,7
2020-12-15T12:52:28.580702,52.5465516667,13.3723933333, none, sw,0.00099937755774638,23,39,46,6963,2090,526,21,8,8,1919,23,16,7
2020-12-15T12:52:29.587686,52.5465566667,13.3723866667, none, sw,0.00099937755774638,21,38,45,6781,2072,383,25,8,8,1919,21,17,7
2020-12-15T12:52:30.604722,52.5465566667,13.372383333299998, none, sw,0.00099937755774638,23,40,47,7014,2097,536,30,8,8,1919,23,17,7
2020-12-15T12:52:31.621275,52.5465583333,13.372378333299999, none, sw,0.00099937755774638,24,42,49,7292,2151,544,30,8,8,1919,24,18,7
2020-12-15T12:52:32.638775,52.5465683333,13.372368333299999, none, sw,0.0011454227108111,24,41,47,7232,2136,542,30,6,6,1919,24,17,6
2020-12-15T12:52:33.655418,52.546580000000006,13.3723583333, none, sw,0.0011454227108111,25,43,49,7456,2168,552,30,6,6,1919,25,18,6
2020-12-15T12:52:34.672910,52.546580000000006,13.372354999999999, none, sw,0.0011454227108111,24,42,49,7465,2168,554,28,8,6,1919,24,18,7
2020-12-15T12:52:35.689142,52.5465816667,13.3723516667, none, sw,0.0011454227108111,25,44,47,7689,2320,554,31,4,2,1919,25,19,3
2020-12-15T12:52:36.706039,52.5465883333,13.372345000000001, none, sw,0.0011454227108111,25,44,47,7689,2320,554,31,4,2,1919,25,19,3
2020-12-15T12:52:37.723061,52.54661,13.372326666700001, none, sw,0.0011454227108111,26,46,49,7967,2370,576,31,4,2,1919,26,20,3
2020-12-15T12:52:38.741151,52.546625,13.3723066667, none, sw,0.0011454227108111,26,46,49,7967,2370,576,31,4,2,1919,26,20,3
2020-12-15T12:52:39.758250,52.5466283333,13.3722966667, none, sw,0.0011454227108111,27,45,48,8042,2392,561,24,4,2,1919,27,18,3
2020-12-15T12:52:40.774931,52.546625,13.37229, none, sw,0.0011759282897893,26,46,49,8260,2412,574,26,4,2,1919,26,20,3
2020-12-15T12:52:41.791207,52.5466283333,13.372281666700001, none, sw,0.0011759282897893,26,46,49,8260,2417,574,26,4,2,1919,26,20,3
2020-12-15T12:52:42.807962,52.5466133333,13.372283333299999, none, sw,0.0011759282897893,26,45,46,8012,2380,561,21,2,0,1919,26,19,1
2020-12-15T12:52:43.823652,52.546594999999996,13.372288333299998, none, sw,0.0011759282897893,26,45,47,8003,2378,561,25,4,2,1919,26,19,2
2020-12-15T12:52:44.841214,52.546580000000006,13.372295000000001, none, sw,0.0011759282897893,25,44,48,7976,2363,558,25,6,4,1919,25,19,4
2020-12-15T12:52:45.856581,52.546569999999996,13.3723016667, none, sw,0.0011759282897893,25,44,48,7991,2351,558,25,6,4,1919,25,19,4
2020-12-15T12:52:46.871829,52.546555000000005,13.37231, none, sw,0.0011759282897893,25,43,46,7967,2346,553,23,4,4,1919,25,18,3
2020-12-15T12:52:47.904300,52.5465416667,13.372320000000002, none, sw,0.0011759282897893,25,42,45,7794,2331,543,16,4,4,1919,25,17,3
2020-12-15T12:52:48.924917,52.546528333299996,13.372329999999998, none, n,0.0015833524766643,24,39,43,7486,2143,531,18,4,4,1919,24,15,4
2020-12-15T12:52:49.941838,52.5465166667,13.37234, none, n,0.0015833524766643,23,40,44,7268,2126,541,22,4,4,1919,23,17,4
2020-12-15T12:52:50.958555,52.5465066667,13.3723483333, none, n,0.0015833524766643,22,39,43,7035,2097,526,24,4,4,1919,22,17,4
2020-12-15T12:52:51.975095,52.5464966667,13.3723583333, none, n,0.0015833524766643,22,39,43,6993,2070,518,24,4,4,1919,22,17,4
2020-12-15T12:52:52.997760,52.5464866667,13.372366666700001, none, n,0.0015833524766643,22,39,43,6993,2070,518,24,4,4,1919,22,17,4
2020-12-15T12:52:54.008538,52.54648,13.372371666700001, none, n,0.0015833524766643,22,38,42,7181,2085,378,22,4,4,1919,22,16,4
2020-12-15T12:52:55.034120,52.546475,13.372378333299999, none, n,0.0015833524766643,22,38,42,7181,2085,378,22,4,4,1919,22,16,4
2020-12-15T12:52:56.049560,52.5464666667,13.372385000000001, none, ne,0.0011143297666209,21,38,42,6972,2065,513,22,4,4,1919,21,17,4
2020-12-15T12:52:57.065816,52.546459999999996,13.3723916667, none, ne,0.0011143297666209,21,38,42,6972,2065,513,22,4,4,1919,21,17,4
2020-12-15T12:52:58.081487,52.5464516667,13.3723983333, none, ne,0.0011143297666209,23,43,46,7683,2170,541,24,4,2,1919,23,20,3
2020-12-15T12:52:59.098223,52.5464466667,13.3724033333, none, ne,0.0011143297666209,24,45,48,7734,2340,551,24,4,2,1919,24,21,3
2020-12-15T12:53:00.115465,52.5464433333,13.3724083333, none, ne,0.0011143297666209,24,46,49,7743,2347,556,26,4,2,1919,24,22,3
2020-12-15T12:53:01.131496,52.546438333299996,13.372413333299999, none, ne,0.0011143297666209,24,45,48,7734,2330,546,26,4,2,1919,24,21,3
2020-12-15T12:53:02.147695,52.5464333333,13.372416666700001, none, ne,0.0011143297666209,24,43,46,7540,2315,526,22,4,2,1919,24,19,3
2020-12-15T12:53:03.167125,52.546438333299996,13.372413333299999, none, ne,0.0011143297666209,23,42,45,7713,2315,521,22,4,2,1919,23,19,3
2020-12-15T12:53:04.185003,52.54645,13.3724033333, none, ne,0.00031863921000703,24,43,45,7782,2337,528,18,4,2,1919,24,19,2
2020-12-15T12:53:05.211894,52.546465000000005,13.372378333299999, none, ne,0.00031863921000703,26,42,45,7976,2362,536,14,4,2,1919,26,16,3
2020-12-15T12:53:06.225706,52.546483333299996,13.3723483333, none, ne,0.00031863921000703,24,45,49,7961,2359,551,28,6,2,1919,24,21,4
2020-12-15T12:53:07.243969,52.54651,13.3723116667, none, ne,0.00031863921000703,27,45,47,7752,2334,526,24,4,0,1919,27,18,2
2020-12-15T12:53:08.260596,52.546526666700004,13.37229, none, ne,0.00031863921000703,24,41,45,7453,2148,370,24,4,2,1919,24,17,4
2020-12-15T12:53:09.282795,52.5465316667,13.3722916667, none, ne,0.00031863921000703,23,41,43,7214,2108,365,26,4,2,1919,23,18,2
2020-12-15T12:53:10.325799,52.5465433333,13.3722866667, none, ne,0.00031863921000703,22,39,43,7005,2074,360,28,6,2,1919,22,17,4
2020-12-15T12:53:11.335074,52.546569999999996,13.3722633333, none, ne,0.00031863921000703,22,39,43,7005,2074,360,28,6,2,1919,22,17,4
2020-12-15T12:53:12.353735,52.5466016667,13.372233333299999, none, sw,0.0029156490779782,22,39,43,6948,2067,363,28,6,2,1919,22,17,4
2020-12-15T12:53:13.376493,52.5466216667,13.372214999999999, none, sw,0.0029156490779782,22,39,43,6948,2067,363,28,6,2,1919,22,17,4
2020-12-15T12:53:14.392569,52.5466483333,13.3722, none, sw,0.0029156490779782,22,39,46,7208,2097,375,30,8,4,1919,22,17,7
2020-12-15T12:53:15.414100,52.5466733333,13.372188333299999, none, sw,0.0029156490779782,22,39,46,7208,2097,375,30,8,4,1919,22,17,7
2020-12-15T12:53:16.430570,52.54671,13.37217, none, sw,0.0029156490779782,22,38,44,7172,2087,375,26,8,4,1919,22,16,6
2020-12-15T12:53:17.447752,52.5467616667,13.372138333299999, none, sw,0.0029156490779782,22,38,44,7172,2087,375,26,8,4,1919,22,16,6
2020-12-15T12:53:18.466855,52.5468066667,13.372105, none, sw,0.0029156490779782,21,36,44,6736,1902,370,28,10,4,1919,21,15,8
2020-12-15T12:53:19.484085,52.546834999999994,13.3720733333, none, sw,0.0029156490779782,21,36,44,6736,1902,370,28,10,4,1919,21,15,8
2020-12-15T12:53:20.500279,52.54685500000001,13.372043333299999, none, sw,0.004422977792875,19,35,41,6503,1875,360,28,10,4,1919,19,16,6
2020-12-15T12:53:21.504970,52.5468666667,13.3720266667, none, sw,0.004422977792875,19,35,41,6503,1875,360,28,10,4,1919,19,16,6
2020-12-15T12:53:23.529516,52.546944999999994,13.371995000000002, none, sw,0.004422977792875,19,33,38,6458,1861,350,16,8,4,1919,19,14,5
2020-12-15T12:53:24.546501,52.546980000000005,13.3719816667, none, sw,0.004422977792875,19,33,38,6458,1861,350,16,8,4,1919,19,14,5
2020-12-15T12:53:25.562197,52.547,13.371975, none, sw,0.004422977792875,21,34,39,6727,1893,363,16,8,4,1919,21,13,5
2020-12-15T12:53:26.577230,52.546996666700004,13.371985, none, sw,0.004422977792875,21,34,39,6727,1893,363,16,8,4,1919,21,13,5
2020-12-15T12:53:27.592883,52.5469916667,13.371986666700002, none, sw,0.004422977792875,18,32,37,6246,1824,351,16,8,2,1919,18,14,5
2020-12-15T12:53:28.608228,52.5470083333,13.37199, none, s,0.0024896124136303,18,32,37,6246,1824,351,16,8,2,1919,18,14,5
2020-12-15T12:53:29.622664,52.5470183333,13.372015, none, s,0.0024896124136303,18,30,36,6246,1814,354,14,8,2,1919,18,12,6
2020-12-15T12:53:30.642081,52.5470283333,13.372055, none, s,0.0024896124136303,18,30,36,6246,1814,354,14,8,2,1919,18,12,6
2020-12-15T12:53:31.665416,52.5470666667,13.372075, none, s,0.0024896124136303,20,34,38,6739,1886,367,19,6,2,1919,20,14,4
2020-12-15T12:53:32.682333,52.5471216667,13.3720716667, none, s,0.0024896124136303,19,37,43,6939,1903,522,26,8,4,1919,19,18,6
2020-12-15T12:53:33.700873,52.5471566667,13.3720616667, none, s,0.0024896124136303,19,37,41,6781,1896,525,24,6,2,1919,19,18,4
2020-12-15T12:53:34.717649,52.5472,13.372048333299999, none, s,0.0024896124136303,19,38,42,6772,1906,527,24,6,2,1919,19,19,4
2020-12-15T12:53:35.733526,52.5472383333,13.37204, none, s,0.0024896124136303,19,38,40,6772,1908,522,22,4,2,1919,19,19,2
2020-12-15T12:53:36.758730,52.5472966667,13.3720216667, none, s,0.0045903940844111,21,40,44,7005,2075,547,24,4,2,1919,21,19,4
2020-12-15T12:53:37.775095,52.547325,13.372020000000001, none, s,0.0045903940844111,21,39,43,6969,2060,532,24,4,2,1919,21,18,4
2020-12-15T12:53:38.794306,52.54734499999999,13.372031666700002, none, s,0.0045903940844111,19,41,44,6757,1910,532,28,4,2,1919,19,22,3
2020-12-15T12:53:39.810607,52.5473816667,13.3720666667, none, s,0.0045903940844111,21,42,43,6915,2055,532,24,2,2,1919,21,21,1
2020-12-15T12:53:40.829398,52.54741,13.3721166667, none, s,0.0045903940844111,21,42,43,6781,2065,532,26,2,2,1919,21,21,1
2020-12-15T12:53:41.854061,52.54746,13.372143333299999, none, s,0.0045903940844111,19,38,41,6512,1895,527,19,2,2,1919,19,19,3
2020-12-15T12:53:42.869377,52.5474916667,13.372145000000002, none, s,0.0045903940844111,21,36,36,6440,1883,367,14,0,0,1919,21,15,0
2020-12-15T12:53:43.885195,52.547515000000004,13.37214, none, s,0.0045903940844111,21,36,36,6255,1868,374,16,0,0,1919,21,15,0
2020-12-15T12:53:44.902349,52.547515000000004,13.372129999999999, none, se,0.0036226524152758,21,36,36,6255,1868,374,16,0,0,1919,21,15,0
2020-12-15T12:53:45.918594,52.5475416667,13.3721166667, none, se,0.0036226524152758,21,37,37,6452,1895,374,16,0,0,1919,21,16,0
2020-12-15T12:53:46.935589,52.54758,13.3721133333, none, se,0.0036226524152758,21,37,37,6452,1895,374,16,0,0,1919,21,16,0
2020-12-15T12:53:47.951031,52.5476416667,13.372093333299999, none, se,0.0036226524152758,22,38,38,6700,2051,377,16,0,0,1919,22,16,0
2020-12-15T12:53:48.967788,52.547709999999995,13.3720783333, none, se,0.0036226524152758,22,38,38,6700,2051,377,16,0,0,1919,22,16,0
2020-12-15T12:53:49.999305,52.5477783333,13.37207, none, se,0.0036226524152758,21,35,35,6446,1874,349,14,0,0,1919,21,14,0
2020-12-15T12:53:51.023320,52.5478416667,13.372095000000002, none, se,0.0036226524152758,21,35,35,6446,1874,349,14,0,0,1919,21,14,0
2020-12-15T12:53:52.039649,52.5479,13.372125, none, s,0.0061158990575947,21,36,38,6476,1891,376,16,4,0,1919,21,15,2
2020-12-15T12:53:53.055955,52.5479583333,13.372135, none, s,0.0061158990575947,21,36,38,6476,1891,376,16,4,0,1919,21,15,2
2020-12-15T12:53:54.072180,52.5479883333,13.372129999999999, none, s,0.0061158990575947,21,34,37,6440,1886,373,12,4,0,1919,21,13,3
2020-12-15T12:53:55.089327,52.5480116667,13.372141666700001, none, s,0.0061158990575947,21,34,37,6440,1886,373,12,4,0,1919,21,13,3
2020-12-15T12:53:56.113142,52.5480366667,13.3721583333, 4homepulse, s,0.0061158990575947,19,33,35,6267,1849,360,12,4,0,1919,19,14,2
2020-12-15T12:53:57.127982,52.548075,13.3721716667, 4homepulse, s,0.0061158990575947,19,33,37,6437,1856,352,17,6,0,1919,19,14,4
2020-12-15T12:53:58.143067,52.5480883333,13.372191666700001, 4homepulse, s,0.0061158990575947,19,33,36,6264,1848,342,15,6,0,1919,19,14,3
2020-12-15T12:53:59.162606,52.5480916667,13.3722133333, 4homepulse, s,0.0061158990575947,19,33,36,6240,1843,344,17,6,0,1919,19,14,3
2020-12-15T12:54:00.187349,52.54809,13.372214999999999, 4homepulse, se,0.0031408686275536,21,34,39,6479,1880,347,24,8,2,1919,21,13,5
2020-12-15T12:54:01.204210,52.548075,13.3722083333, 4homepulse, se,0.0031408686275536,19,36,42,6455,1872,362,38,8,2,1919,19,17,6
2020-12-15T12:54:02.221051,52.5480833333,13.3721983333, 4homepulse, se,0.0031408686275536,19,37,43,6431,1877,362,40,8,2,1919,19,18,6
2020-12-15T12:54:03.240200,52.5480933333,13.372176666700001, 4homepulse, se,0.0031408686275536,21,39,46,6661,1904,382,47,10,4,1919,21,18,7
2020-12-15T12:54:04.264563,52.5481016667,13.372155, 4homepulse, se,0.0031408686275536,19,38,44,6494,1882,367,45,6,4,1919,19,19,6
2020-12-15T12:54:05.281976,52.5481233333,13.372133333299999, 4homepulse, se,0.0031408686275536,19,41,46,6464,1875,523,49,8,6,1919,19,22,5
2020-12-15T12:54:06.300630,52.5481316667,13.3721216667, 4homepulse, se,0.0031408686275536,19,42,49,6494,1897,543,53,10,8,1919,19,23,7
2020-12-15T12:54:07.324386,52.5481533333,13.372110000000001, 4homepulse, se,0.0031408686275536,19,41,49,6509,1905,536,48,10,8,1919,19,22,8
2020-12-15T12:54:08.346844,52.5481983333,13.372098333299999, 4homepulse, sw,0.0020569861013729996,20,41,49,6515,1903,528,48,10,8,1919,20,21,8
2020-12-15T12:54:09.367941,52.548255000000005,13.3721033333, 4homepulse, sw,0.0020569861013729996,20,41,49,6515,1903,528,48,10,8,1919,20,21,8
2020-12-15T12:54:10.384504,52.54829,13.372114999999999, 4homepulse, sw,0.0020569861013729996,21,43,51,6709,2055,546,44,10,8,1919,21,22,8
2020-12-15T12:54:11.402283,52.5483166667,13.3721183333, 4homepulse, sw,0.0020569861013729996,21,43,51,6709,2055,546,44,10,8,1919,21,22,8
2020-12-15T12:54:12.421152,52.5483266667,13.372131666700001, 4homepulse, sw,0.0020569861013729996,21,41,48,6739,2060,533,37,8,6,1919,21,20,7
2020-12-15T12:54:13.439615,52.548341666700004,13.3721516667, 4homepulse, sw,0.0020569861013729996,21,41,48,6739,2060,533,37,8,6,1919,21,20,7
2020-12-15T12:54:14.458090,52.548365000000004,13.3721733333, 4homepulse, sw,0.0020569861013729996,20,37,43,6440,1880,380,23,8,6,1919,20,17,6
2020-12-15T12:54:15.482613,52.548390000000005,13.3721983333, 4homepulse, sw,0.0020569861013729996,21,35,42,6455,1885,377,21,8,6,1919,21,14,7
2020-12-15T12:54:16.505052,52.5484216667,13.372221666700002, 4homepulse, se,0.0037423523062954,21,34,39,6270,1868,357,14,6,4,1919,21,13,5
2020-12-15T12:54:17.523664,52.548444999999994,13.3722416667, 4homepulse, se,0.0037423523062954,20,34,39,6225,1863,352,14,6,4,1919,20,14,5
2020-12-15T12:54:19.543015,52.5485116667,13.3722466667, 4homepulse, se,0.0037423523062954,20,32,35,6219,1848,332,12,4,2,1919,20,12,3
2020-12-15T12:54:20.560143,52.5485366667,13.372238333299999, 4homepulse, se,0.0037423523062954,21,33,34,6219,1853,332,10,2,0,1919,21,12,1
2020-12-15T12:54:21.576300,52.548575,13.372229999999998, 4homepulse, se,0.0037423523062954,20,33,33,6147,1826,332,12,0,0,1919,20,13,0
2020-12-15T12:54:22.595995,52.548615000000005,13.372238333299999, 4homepulse, se,0.0037423523062954,20,33,35,6013,1826,337,14,2,2,1919,20,13,2
2020-12-15T12:54:23.615867,52.5486533333,13.3722633333, 4homepulse, se,0.0037423523062954,20,32,34,6007,1824,327,14,2,2,1919,20,12,2
2020-12-15T12:54:24.634181,52.548675,13.3722933333, 4homepulse, s,0.0040833215621393,19,32,35,5759,1659,325,19,4,4,1919,19,13,3
2020-12-15T12:54:25.653713,52.548723333299996,13.372318333299999, 4homepulse, s,0.0040833215621393,20,33,36,6180,1827,340,19,4,4,1919,20,13,3
2020-12-15T12:54:26.676456,52.5487616667,13.3723483333, 4homepulse, s,0.0040833215621393,21,35,40,6413,1856,355,21,6,4,1919,21,14,5
2020-12-15T12:54:27.695812,52.5487916667,13.3723816667, 4homepulse, s,0.0040833215621393,21,36,41,6449,1883,378,21,6,4,1919,21,15,5
2020-12-15T12:54:28.714065,52.548815000000005,13.372425, 4homepulse, s,0.0040833215621393,21,36,41,6449,1883,378,21,6,4,1919,21,15,5
2020-12-15T12:54:29.716223,52.5488416667,13.372470000000002, 4homepulse, s,0.0040833215621393,21,37,42,6661,1903,383,19,6,4,1919,21,16,5
2020-12-15T12:54:30.738506,52.548878333299996,13.372513333299999, 4homepulse, s,0.0040833215621393,21,37,42,6661,1903,383,19,6,4,1919,21,16,5
2020-12-15T12:54:31.751980,52.54891,13.372539999999999, 4homepulse, s,0.0040833215621393,23,39,43,6778,2083,513,17,6,4,1919,23,16,4
2020-12-15T12:54:32.776989,52.5489566667,13.3725466667, 4homepulse, se,0.0050997243694111,23,39,43,6778,2083,513,17,6,4,1919,23,16,4
2020-12-15T12:54:33.794756,52.54900500000001,13.372558333299999, 4homepulse, se,0.0050997243694111,23,40,45,6996,2106,528,22,8,4,1919,23,17,5
2020-12-15T12:54:34.811419,52.5490533333,13.3725716667, 4homepulse, se,0.0050997243694111,23,40,45,6996,2106,528,22,8,4,1919,23,17,5
2020-12-15T12:54:35.828647,52.549094999999994,13.372589999999999, 4homepulse, se,0.0050997243694111,23,40,46,7002,2111,535,18,8,4,1919,23,17,6
2020-12-15T12:54:36.845775,52.549130000000005,13.372620000000001, 4homepulse, se,0.0050997243694111,23,40,46,7002,2111,535,18,8,4,1919,23,17,6
2020-12-15T12:54:37.863446,52.5491683333,13.372645, 4homepulse, se,0.0050997243694111,22,39,43,6769,2071,528,16,6,2,1919,22,17,4
2020-12-15T12:54:38.884005,52.549195,13.3726766667, 4homepulse, se,0.0050997243694111,22,37,43,6688,1911,520,20,8,2,1919,22,15,6
2020-12-15T12:54:39.900862,52.549209999999995,13.372703333299999, 4homepulse, se,0.0050997243694111,22,40,43,6936,2083,535,15,6,0,1919,22,18,3
2020-12-15T12:54:40.919245,52.5492233333,13.3727283333, 4homepulse, se,0.0045851019150724,22,38,42,6667,1915,528,15,6,0,1919,22,16,4
2020-12-15T12:54:41.935050,52.5492333333,13.372760000000001, 4homepulse, se,0.0045851019150724,20,36,38,6219,1856,516,15,4,0,1919,20,16,2
2020-12-15T12:54:42.951677,52.5492516667,13.3728, 4homepulse, se,0.0045851019150724,21,37,42,6198,1846,378,27,6,0,1919,21,16,5
2020-12-15T12:54:43.984390,52.5492616667,13.372825, 4homepulse, se,0.0045851019150724,20,39,43,6168,1841,378,29,8,2,1919,20,19,4
2020-12-15T12:54:45.005120,52.54928,13.372845000000002, 4homepulse, se,0.0045851019150724,20,38,42,5995,1821,358,31,8,2,1919,20,18,4
2020-12-15T12:54:46.021826,52.5492916667,13.372843333299999, 4homepulse, se,0.0045851019150724,20,36,41,5995,1821,343,26,8,2,1919,20,16,5
2020-12-15T12:54:47.038726,52.549319999999994,13.3728583333, 4homepulse, se,0.0045851019150724,20,34,41,6144,1818,336,28,10,2,1919,20,14,7
2020-12-15T12:54:48.069165,52.5493416667,13.372885, 4homepulse, se,0.0024131926377414,21,36,43,6228,1855,343,30,10,2,1919,21,15,7
2020-12-15T12:54:49.085632,52.549369999999996,13.3729033333, 4homepulse, se,0.0024131926377414,20,36,42,6234,1862,351,26,8,2,1919,20,16,6
2020-12-15T12:54:50.102732,52.5494066667,13.3729233333, 4homepulse, se,0.0024131926377414,19,36,43,6159,1828,348,31,10,2,1919,19,17,7
2020-12-15T12:54:51.119662,52.549434999999995,13.3729516667, 4homepulse, se,0.0024131926377414,19,36,43,6159,1828,348,31,10,2,1919,19,17,7
2020-12-15T12:54:52.138516,52.5494583333,13.372975, 4homepulse, se,0.0024131926377414,19,36,44,6165,1828,355,33,12,2,1919,19,17,8
2020-12-15T12:54:53.152718,52.5494683333,13.3729983333, 4homepulse, se,0.0024131926377414,19,39,47,6246,1860,372,38,12,2,1919,19,20,8
2020-12-15T12:54:54.191002,52.5494916667,13.373021666700001, 2christianWall, se,0.0024131926377414,19,35,42,6186,1835,357,28,10,2,1919,19,16,7
2020-12-15T12:54:55.209475,52.549505,13.373025, 2christianWall, se,0.0024131926377414,20,36,41,6431,1869,357,26,8,0,1919,20,16,5
2020-12-15T12:54:56.241434,52.5495033333,13.373035, 2christianWall, se,0.0029485825515078,19,36,44,6246,1849,370,28,12,2,1919,19,17,8
2020-12-15T12:54:57.258708,52.5494966667,13.373031666700001, 2christianWall, se,0.0029485825515078,20,38,44,6494,1886,373,28,10,2,1919,20,18,6
2020-12-15T12:54:58.276096,52.54949499999999,13.3730166667, 2christianWall, se,0.0029485825515078,20,40,45,6518,1903,526,28,8,2,1919,20,20,5
2020-12-15T12:54:59.300627,52.5494916667,13.372988333299999, 4homepulse, se,0.0029485825515078,19,40,47,6458,1883,529,33,10,4,1919,19,21,7
2020-12-15T12:55:00.336789,52.5495516667,13.372938333299999, 2christianWall, se,0.0029485825515078,20,41,48,6518,1896,536,37,10,4,1919,20,21,7
2020-12-15T12:55:01.352887,52.5496216667,13.3728783333, 2christianWall, se,0.0029485825515078,20,40,45,6494,1891,526,34,8,4,1919,20,20,5
2020-12-15T12:55:02.382475,52.5496783333,13.3728133333, 2christianWall, se,0.0029485825515078,21,42,47,6727,2059,534,34,6,4,1919,21,21,5
2020-12-15T12:55:03.400115,52.549708333299996,13.372765, 2christianWall, se,0.0029485825515078,21,40,44,6691,1911,522,29,6,4,1919,21,19,4
2020-12-15T12:55:04.434085,52.549735,13.372706666700001, 2christianWall, sw,0.0048580649296178,21,41,45,6712,2052,529,34,6,4,1919,21,20,4
2020-12-15T12:55:05.451526,52.54976,13.37265, 2christianWall, sw,0.0048580649296178,21,41,45,6712,2052,529,34,6,4,1919,21,20,4
2020-12-15T12:55:06.471924,52.5497833333,13.372595, 2christianWall, sw,0.0048580649296178,20,40,47,6509,1900,517,38,8,4,1919,20,20,7
2020-12-15T12:55:07.498832,52.549794999999996,13.37253, 2christianWall, sw,0.0048580649296178,20,40,46,6509,1900,517,38,8,4,1919,20,20,6
2020-12-15T12:55:08.514450,52.5498166667,13.372471666700001, 2christianWall, sw,0.0048580649296178,21,40,45,6718,2055,512,38,8,4,1919,21,19,5
2020-12-15T12:55:10.533485,52.5498866667,13.3723116667, 2christianWall, sw,0.0048580649296178,21,40,45,6718,2055,512,38,8,4,1919,21,19,5
2020-12-15T12:55:11.539030,52.549905,13.37226, 2christianWall, sw,0.0048580649296178,20,40,45,6521,1907,514,38,8,4,1919,20,20,5
2020-12-15T12:55:12.579979,52.5499233333,13.3722083333, 2christianWall, w,0.005667452140143,20,40,45,6521,1907,514,38,8,4,1919,20,20,5
2020-12-15T12:55:13.599602,52.54994,13.372160000000001, 2christianWall, w,0.005667452140143,20,39,46,6491,1888,368,38,10,6,1919,20,19,7
2020-12-15T12:55:14.618302,52.5499583333,13.372110000000001, 2christianWall, w,0.005667452140143,20,39,46,6491,1888,368,38,10,6,1919,20,19,7
2020-12-15T12:55:15.635967,52.5499766667,13.3720583333, 2christianWall, w,0.005667452140143,21,39,44,6775,2058,365,33,8,4,1919,21,18,5
2020-12-15T12:55:16.653878,52.549994999999996,13.3720066667, 2christianWall, w,0.005667452140143,21,39,44,6775,2058,365,33,8,4,1919,21,18,5
2020-12-15T12:55:17.672484,52.5500116667,13.371958333299999, 2christianWall, w,0.005667452140143,21,38,45,6769,2053,353,33,10,4,1919,21,17,7
2020-12-15T12:55:18.689811,52.5500283333,13.37191, 2christianWall, w,0.005667452140143,21,37,45,6769,2053,353,33,10,4,1919,21,16,8
2020-12-15T12:55:19.707548,52.5500466667,13.371863333299999, 2christianWall, w,0.005667452140143,21,37,46,6912,2072,363,31,12,4,1919,21,16,9
2020-12-15T12:55:20.740773,52.5500666667,13.371813333299999, 2christianWall, w,0.0044431011066066,21,37,46,6912,2072,363,31,12,4,1919,21,16,9
2020-12-15T12:55:21.758494,52.550086666700004,13.371761666700001, 2christianWall, w,0.0044431011066066,22,36,45,6912,2065,350,31,14,4,1919,22,14,9
2020-12-15T12:55:22.776134,52.5501083333,13.371711666700001, 2christianWall, w,0.0044431011066066,22,36,45,6912,2065,350,31,14,4,1919,22,14,9
2020-12-15T12:55:23.793944,52.550131666700004,13.37166, 2christianWall, w,0.0044431011066066,22,37,46,6912,2073,360,31,14,4,1919,22,15,9
2020-12-15T12:55:24.811885,52.5501566667,13.371611666700002, 2christianWall, w,0.0044431011066066,22,37,46,6912,2073,360,31,14,4,1919,22,15,9
2020-12-15T12:55:25.829266,52.5501816667,13.371568333299999, 2christianWall, w,0.0044431011066066,22,36,46,6951,2078,358,26,16,4,1919,22,14,10
2020-12-15T12:55:26.846386,52.5502083333,13.371528333299999, 2christianWall, w,0.0044431011066066,22,36,46,6951,2078,358,26,16,4,1919,22,14,10
2020-12-15T12:55:27.862347,52.5502316667,13.3714933333, 2christianWall, w,0.0044431011066066,21,35,50,6781,2068,370,29,21,6,1919,21,14,15
2020-12-15T12:55:28.901670,52.55025,13.371455, 2christianWall, sw,0.0045233903999415,21,35,50,6781,2068,370,29,21,6,1919,21,14,15
2020-12-15T12:55:29.919224,52.5502683333,13.371425, 2christianWall, sw,0.0045233903999415,21,35,46,6691,1913,365,25,17,4,1919,21,14,11
2020-12-15T12:55:30.936289,52.5502866667,13.371393333299999, 2christianWall, sw,0.0045233903999415,21,35,46,6691,1913,365,25,17,4,1919,21,14,11
2020-12-15T12:55:31.960850,52.550305,13.3713583333, 2christianWall, sw,0.0045233903999415,20,35,46,6482,1878,365,27,17,4,1919,20,15,11
2020-12-15T12:55:32.977705,52.5503183333,13.3713216667, 2christianWall, sw,0.0045233903999415,20,35,46,6482,1878,365,27,17,4,1919,20,15,11
2020-12-15T12:55:33.995701,52.5503233333,13.3713016667, 2christianWall, sw,0.0045233903999415,20,34,43,6446,1870,358,25,15,2,1919,20,14,9
2020-12-15T12:55:35.017911,52.550325,13.37127, 2christianWall, sw,0.0045233903999415,20,34,43,6446,1870,358,25,15,2,1919,20,14,9
2020-12-15T12:55:36.032685,52.5503283333,13.371241666700001, 1startpulse, w,0.0024072019536621,20,33,42,6207,1838,356,23,15,2,1919,20,13,9
2020-12-15T12:55:37.064032,52.5503316667,13.371215, 1startpulse, w,0.0024072019536621,20,33,42,6207,1838,356,23,15,2,1919,20,13,9
2020-12-15T12:55:38.080947,52.5503383333,13.3711833333, 1startpulse, w,0.0024072019536621,20,33,41,6228,1853,363,19,13,2,1919,20,13,8
2020-12-15T12:55:39.103457,52.5503466667,13.371153333299999, 1startpulse, w,0.0024072019536621,20,33,41,6228,1853,363,19,13,2,1919,20,13,8
2020-12-15T12:55:40.124655,52.55035,13.371129999999999, 1startpulse, w,0.0024072019536621,18,32,40,6192,1836,358,19,11,2,1919,18,14,8
2020-12-15T12:55:41.141393,52.55035,13.3711183333, 1startpulse, w,0.0024072019536621,18,32,40,6192,1836,358,19,11,2,1919,18,14,8
2020-12-15T12:55:42.161211,52.5503533333,13.371101666700001, 1startpulse, w,0.0024072019536621,18,33,40,6192,1836,361,17,9,2,1919,18,15,7
2020-12-15T12:55:43.178210,52.5503583333,13.3710866667, 1startpulse, w,0.0024072019536621,18,33,40,6192,1836,361,17,9,2,1919,18,15,7
2020-12-15T12:55:44.209156,52.5503666667,13.371070000000001, 1startpulse, w,0.0017664193345576,18,32,37,6162,1818,343,15,9,2,1919,18,14,5
2020-12-15T12:55:45.226155,52.5503716667,13.371061666700001, 1startpulse, w,0.0017664193345576,18,32,37,6162,1818,343,15,9,2,1919,18,14,5
2020-12-15T12:55:46.243353,52.550378333299996,13.371046666700002, 1startpulse, w,0.0017664193345576,17,31,35,5950,1660,340,13,7,2,1919,17,14,4
2020-12-15T12:55:47.247155,52.550385,13.3710283333, 1startpulse, w,0.0017664193345576,17,31,35,5950,1660,340,13,7,2,1919,17,14,4
2020-12-15T12:55:48.267792,52.550394999999995,13.371015, 1startpulse, w,0.0017664193345576,18,32,32,5965,1795,333,8,0,0,1919,18,14,0
2020-12-15T12:55:49.284512,52.5503983333,13.3710033333, 1startpulse, w,0.0017664193345576,18,32,32,5965,1795,333,8,0,0,1919,18,14,0
2020-12-15T12:55:50.301470,52.5503983333,13.370995, 1startpulse, w,0.0017664193345576,18,32,32,5989,1798,338,8,0,0,1919,18,14,0
2020-12-15T12:55:51.326131,52.5504066667,13.3709933333, 1startpulse, w,0.0017664193345576,18,32,32,5989,1798,338,8,0,0,1919,18,14,0
2020-12-15T12:55:52.355712,52.5504166667,13.370985000000001, 1startpulse, sw,0.0011423676016283,18,31,31,5995,1813,331,4,0,0,1919,18,13,0
2020-12-15T12:55:53.374478,52.5504266667,13.3709783333, 1startpulse, sw,0.0011423676016283,18,31,31,5995,1813,331,4,0,0,1919,18,13,0
2020-12-15T12:55:54.391962,52.5504283333,13.370975, 1startpulse, sw,0.0011423676016283,19,32,34,6010,1828,348,8,4,0,1919,19,13,2
2020-12-15T12:55:55.409088,52.5504283333,13.370971666700001, 1startpulse, sw,0.0011423676016283,19,32,34,6010,1828,348,8,4,0,1919,19,13,2
2020-12-15T12:55:56.427837,52.5504316667,13.370965, 1startpulse, sw,0.0011423676016283,18,32,34,6144,1831,353,8,4,0,1919,18,14,2
2020-12-15T12:55:57.435576,52.550435,13.370961666700001, 1startpulse, sw,0.0011423676016283,18,32,34,6144,1831,353,8,4,0,1919,18,14,2
2020-12-15T12:55:58.453526,52.55044,13.3709533333, 1startpulse, sw,0.0011423676016283,18,32,35,5995,1818,356,10,6,0,1919,18,14,3
2020-12-15T12:55:59.470188,52.5504383333,13.3709416667, 1startpulse, sw,0.0011423676016283,18,32,35,5995,1818,356,10,6,0,1919,18,14,3
2020-12-15T12:56:00.500350,52.5504316667,13.3709366667, 1startpulse, w,0.0005242096078478901,19,32,36,6234,1840,354,10,6,0,1919,19,13,4
2020-12-15T12:56:01.503156,52.550430000000006,13.3709366667, 1startpulse, w,0.0005242096078478901,19,32,36,6234,1840,354,10,6,0,1919,19,13,4
2020-12-15T12:56:03.523425,52.5504166667,13.3709483333, 1startpulse, w,0.0005242096078478901,21,31,36,6168,1822,354,12,8,2,1919,21,10,5
2020-12-15T12:56:04.545047,52.5504083333,13.3709533333, 1startpulse, w,0.0005242096078478901,21,30,36,6168,1822,354,12,8,2,1919,21,9,6
2020-12-15T12:56:05.563384,52.5503883333,13.370958333299999, 1startpulse, w,0.0005242096078478901,21,30,37,6234,1842,352,14,10,2,1919,21,9,7
2020-12-15T12:56:06.581042,52.5503666667,13.37096, 1startpulse, w,0.0005242096078478901,21,30,37,6234,1842,352,14,10,2,1919,21,9,7
2020-12-15T12:56:07.600592,52.5503583333,13.370958333299999, 1startpulse, w,0.0005242096078478901,21,32,38,6446,1869,372,14,10,2,1919,21,11,6
2020-12-15T12:56:08.634151,52.5503633333,13.370961666700001, 1startpulse, n,0.0011119337999389999,21,32,38,6446,1869,372,14,10,2,1919,21,11,6
2020-12-15T12:56:09.652605,52.55036,13.370968333299999, 1startpulse, n,0.0011119337999389999,21,33,41,6467,1872,520,14,12,4,1919,21,12,8
2020-12-15T12:56:10.674817,52.5503683333,13.37098, 1startpulse, n,0.0011119337999389999,21,33,41,6467,1872,520,14,12,4,1919,21,12,8
2020-12-15T12:56:11.692083,52.5503916667,13.3709983333, 1startpulse, n,0.0011119337999389999,22,32,41,6458,1874,382,14,12,4,1919,22,10,9
2020-12-15T12:56:12.709496,52.5504033333,13.371020000000001, 1startpulse, n,0.0011119337999389999,22,32,41,6458,1874,382,14,12,4,1919,22,10,9
2020-12-15T12:56:13.728137,52.5504083333,13.3710366667, 1startpulse, n,0.0011119337999389999,21,31,39,6213,1832,374,14,12,4,1919,21,10,8
2020-12-15T12:56:14.746048,52.5504016667,13.371061666700001, 1startpulse, n,0.0011119337999389999,21,31,39,6213,1832,374,14,12,4,1919,21,10,8
2020-12-15T12:56:15.764820,52.5503983333,13.371085, 1startpulse, n,0.0011119337999389999,21,31,36,6183,1812,359,10,8,4,1919,21,10,5
2020-12-15T12:56:16.796910,52.5503916667,13.371103333299999, 1startpulse, e,0.0014405313875295,21,31,36,6183,1812,359,10,8,4,1919,21,10,5
2020-12-15T12:56:17.814603,52.5503866667,13.371120000000001, 1startpulse, e,0.0014405313875295,19,31,37,5980,1797,364,14,8,4,1919,19,12,6
2020-12-15T12:56:18.836027,52.5503816667,13.3711383333, 1startpulse, e,0.0014405313875295,19,31,37,5980,1797,364,14,8,4,1919,19,12,6
2020-12-15T12:56:19.853040,52.550375,13.371154999999998, 1startpulse, e,0.0014405313875295,19,31,37,5986,1797,371,16,6,4,1919,19,12,6
2020-12-15T12:56:20.868831,52.550369999999994,13.3711733333, 1startpulse, e,0.0014405313875295,19,31,37,5986,1797,371,16,6,4,1919,19,12,6
2020-12-15T12:56:21.894561,52.5503633333,13.371189999999999, 1startpulse, e,0.0014405313875295,19,31,35,5741,1635,368,14,6,4,1919,19,12,4
2020-12-15T12:56:22.911632,52.5503583333,13.371208333299998, 1startpulse, e,0.0014405313875295,19,31,35,5741,1635,368,14,6,4,1919,19,12,4
2020-12-15T12:56:23.930748,52.5503516667,13.371225, 1startpulse, e,0.0014405313875295,17,31,34,5726,1630,368,12,4,2,1919,17,14,3
2020-12-15T12:56:24.970176,52.5503466667,13.371243333299999, 1startpulse, e,0.0015295836526662,17,30,34,5726,1630,368,12,4,2,1919,17,13,4
2020-12-15T12:56:26.000450,52.550340000000006,13.3712616667, 2christianWall, e,0.0015295836526662,17,30,33,5651,1608,368,12,4,2,1919,17,13,3
2020-12-15T12:56:27.016574,52.550335,13.3712783333, 2christianWall, e,0.0015295836526662,17,30,33,5651,1608,368,12,4,2,1919,17,13,3
2020-12-15T12:56:28.033884,52.5503283333,13.371296666700001, 2christianWall, e,0.0015295836526662,17,29,32,5493,1608,343,12,4,2,1919,17,12,3
2020-12-15T12:56:29.053346,52.5503233333,13.3713133333, 2christianWall, e,0.0015295836526662,17,29,32,5493,1608,343,12,4,2,1919,17,12,3
2020-12-15T12:56:30.069874,52.5503183333,13.371331666700002, 2christianWall, e,0.0015295836526662,17,29,30,5433,1593,320,14,2,0,1919,17,12,1
